阿拉伯语	ālābóyǔ
哎	āi
哎呀	āiyā
哀求	āiqiú
挨家挨户	āijiāāihù
癌	ái
癌症	áizhèng
艾滋病	àizībìng
唉	āi
爱不释手	àibùshìshǒu
爱理不理	àilǐbùlǐ
爱面子	àimiànzi
爱惜	àixī
碍事	àishì
安定	āndìng
安抚	ānfǔ
安眠药	ānmiányào
安宁	ānníng
安稳	ānwěn
安心	ānxīn
安逸	ānyì
按键	ànjiàn
按理说	ànlǐshuō
按说	ànshuō
案件	ànjiàn
暗地里	àndìli
暗杀	ànshā
暗中	ànzhōng
昂贵	ángguì
凹	āo
熬	áo
熬夜	áoyè
傲	ào
傲慢	àomàn
奥秘	àomì
奥运会	àoyùnhuì
八卦	bāguà
巴不得	bābude
扒	pá
芭蕾	bālěi
把柄	bǎbǐng
把关	bǎguān
把手	bǎshǒu
靶子	bǎzi
坝	bà
罢免	bàmiǎn
罢休	bàxiū
霸占	bàzhàn
掰	bāi
白白	báibái
百分比	bǎifēnbǐ
百合	bǎihé
百科全书	bǎikēquánshū
柏树	bǎishù
摆放	bǎifàng
摆平	bǎipíng
摆设	bǎishe
拜会	bàihuì
拜见	bàijiàn
拜年	bàinián
拜托	bàituō
扳	bān
颁布	bānbù
颁发	bānfā
颁奖	bānjiǎng
斑点	bāndiǎn
搬迁	bānqiān
板块	bǎnkuài
办不到	bànbudào
半边天	bànbiāntiān
半场	bànchǎng
半岛	bàndǎo
半路	bànlù
半数	bànshù
半途而废	bàntúérfèi
半信半疑	bànxìnbànyí
半真半假	bànzhēnbànjiǎ
扮	bàn
伴	bàn
伴侣	bànlǚ
伴随	bànsuí
伴奏	bànzòu
拌	bàn
帮手	bāngshǒu
绑	bǎng
绑架	bǎngjià
榜样	bǎngyàng
棒球	bàngqiú
磅	bàng
包袱	bāofu
包容	bāoróng
包扎	bāozā
剥	bō
煲	bāo
饱和	bǎohé
饱满	bǎomǎn
宝库	bǎokù
宝藏	bǎozàng
保管	bǎoguǎn
保姆	bǎomǔ
保暖	bǎonuǎn
保鲜	bǎoxiān
保修	bǎoxiū
保佑	bǎoyòu
保障	bǎozhàng
保质期	bǎozhìqī
保重	bǎozhòng
堡垒	bǎolěi
报	bào
报仇	bàochóu
报酬	bàochóu
报废	bàofèi
报复	bàofù
报社	bàoshè
报亭	bàotíng
报销	bàoxiāo
抱负	bàofù
豹	bào
暴风骤雨	bàofēngzhòuyǔ
暴利	bàolì
暴躁	bàozào
曝光	bàoguāng
爆冷门	bàolěngmén
爆满	bàomǎn
爆竹	bàozhú
卑鄙	bēibǐ
悲哀	bēiāi
悲观	bēiguān
悲欢离合	bēihuānlíhé
悲痛	bēitòng
碑	bēi
贝壳	bèiké
备课	bèikè
备受	bèishòu
备用	bèiyòng
背面	bèimiàn
背叛	bèipàn
背诵	bèisòng
被捕	bèibǔ
奔波	bēnbō
奔赴	bēnfù
本分	běnfèn
本能	běnnéng
本钱	běnqián
本色	běnshǎi
本性	běnxìng
本意	běnyì
本着	běnzhe
奔	bēn
笨蛋	bèndàn
笨重	bènzhòng
崩溃	bēngkuì
绷	bèng
绷带	bēngdài
蹦	bèng
逼近	bījìn
逼迫	bīpò
逼真	bīzhēn
鼻涕	bítì
比比皆是	bǐbǐjiēshì
比不上	bǐbùshàng
比起	bǐqǐ
比试	bǐshì
比喻	bǐyù
鄙视	bǐshì
必不可少	bìbùkěshǎo
必定	bìdìng
碧绿	bìlǜ
弊病	bìbìng
弊端	bìduān
壁画	bìhuà
避难	bìnàn
避暑	bìshǔ
边疆	biānjiāng
边界	biānjiè
边远	biānyuǎn
编号	biānhào
编剧	biānjù
编排	biānpái
编写	biānxiě
编造	biānzào
鞭策	biāncè
鞭炮	biānpào
贬值	biǎnzhí
变革	biàngé
变幻莫测	biànhuànmòcè
变迁	biànqiān
变异	biànyì
变质	biànzhì
便道	biàn dào
便饭	biànfàn
便捷	biànjié
便利店	biànlìdiàn
遍布	biànbù
辨别	biànbié
辨认	biànrèn
辩	biàn
辩护	biànhù
辩解	biànjiě
辫子	biànzi
标	biāo
标榜	biāobǎng
标本	biāoběn
标签	biāoqiān
标示	biāoshì
标语	biāoyǔ
标致	biāozhi
飙升	biāoshēng
表白	biǎobái
表决	biǎojué
表述	biǎoshù
表率	biǎoshuài
表态	biǎotài
表彰	biǎozhāng
憋	biē
别具匠心	biéjùjiàngxīn
别看	biékàn
别墅	biéshù
别说	biéshuō
别提了	biétí le
别致	biézhì
别扭	bièniu
彬彬有礼	bīnbīnyǒulǐ
滨海	bīnhǎi
缤纷	bīnfēn
冰棍儿	bīnggùnr
冰山	bīngshān
丙	bǐng
秉承	bǐngchéng
并非	bìngfēi
并购	bìnggòu
并列	bìngliè
并行	bìngxíng
病床	bìngchuáng
病症	bìngzhèng
拨	bō
拨款	bōkuǎn
拨通	bōtōng
波及	bōjí
波澜	bōlán
波涛	bōtāo
波折	bōzhé
剥夺	bōduó
剥削	bōxuē
伯伯	bóbo
伯父	bófù
伯母	bómǔ
驳回	bóhuí
脖子	bózi
搏斗	bódòu
不定	bùdìng
不见得	bùjiànde
不利于	bulìyú
不慎	bùshèn
不适	bùshì
不算	busuàn
不像话	bùxiànghuà
不屑	bùxiè
不懈	bùxiè
不亚于	bùyàyú
不亦乐乎	bùyìlèhū
不翼而飞	bùyìérfēi
不用说	bùyòngshuō
不正之风	bùzhèngzhīfēng
补给	bǔjǐ
补救	bǔjiù
捕捉	bǔzhuō
哺育	bǔyù
不耻下问	bùchǐxiàwèn
不辞而别	bùcíérbié
不得而知	bùdéérzhī
不得已	bùdéyǐ
不妨	bùfáng
不服	bùfú
不服气	bufúqì
不假思索	bùjiǎsīsuǒ
不解	bùjiě
不经意	bùjīngyì
不景气	bùjǐngqì
不堪	bùkān
不可避免	bùkěbìmiǎn
不可思议	bùkěsīyì
不肯	bùkěn
不理	bùlǐ
不了了之	bùliǎoliǎozhī
不难	bunán
不平	bùpíng
不起眼	bùqǐyǎn
不容	bùróng
不如说	burúshuō
不同寻常	butóngxúncháng
不为人知	bùwéirénzhī
不惜	bùxī
不相上下	bùxiāngshàngxià
不宜	bùyí
不已	bùyǐ
不以为然	bùyǐwéirán
不由得	bùyóude
不由自主	bùyóuzìzhǔ
不予	bùyǔ
不约而同	bùyuēértóng
不知	bùzhī
不知不觉	bùzhībùjué
不准	bùzhǔn
布局	bùjú
步伐	bùfá
步入	bùrù
步骤	bùzhòu
部件	bùjiàn
部署	bùshǔ
猜谜	cāimèi
猜想	cāixiǎng
才华	cáihuá
财经	cáijīng
财力	cáilì
财务	cáiwù
财物	cáiwù
财政	cáizhèng
裁	cái
裁定	cáidìng
裁决	cáijué
采	cǎi
采集	cǎijí
采矿	cǎikuàng
彩电	cǎidiàn
彩虹	cǎihóng
彩霞	cǎixiá
菜市场	càishìchǎng
参见	cānjiàn
参军	cānjūn
参谋	cānmóu
参照	cānzhào
餐桌	cānzhuō
残	cán
残留	cánliú
残缺	cánquē
残忍	cánrěn
惭愧	cánkuì
惨白	cǎnbái
惨痛	cǎntòng
惨重	cǎnzhòng
灿烂	cànlàn
苍蝇	cāngying
沧桑	cāngsāng
舱	cāng
藏匿	cángnì
藏品	cángpǐn
藏身	cángshēn
操控	cāokòng
操劳	cāoláo
操心	cāoxīn
槽	cáo
草案	cǎoàn
草坪	cǎopíng
侧面	cèmiàn
侧重	cèzhòng
测算	cèsuàn
测验	cèyàn
层出不穷	céngchūbùqióng
蹭	cèng
差错	chācuò
差额	chāé
插手	chāshǒu
插图	chātú
插嘴	chāzuǐ
茶道	chádào
茶馆儿	cháguǎn r
查处	cháchǔ
查明	chámíng
查找	cházhǎo
察觉	chájué
察看	chákàn
诧异	chàyì
掺	shǎn
搀	chān
馋	chán
禅杖	chánzhàng
缠	chán
产	chǎn
产地	chǎndì
产物	chǎnwù
产值	chǎnzhí
铲	chǎn
铲子	chǎnzi
阐述	chǎnshù
颤抖	chàndǒu
猖狂	chāngkuáng
长达	cháng dá
长期以来	chángqīyǐlái
长效	chángxiào
长征	chángzhēng
长足	chángzú
常理	chánglǐ
常人	chángrén
常态	chángtài
常温	chángwēn
偿还	chánghuán
嫦娥	chángé
厂家	chǎngjiā
敞开	chǎngkāi
畅谈	chàngtán
畅销	chàngxiāo
倡议	chàngyì
抄袭	chāoxí
钞票	chāopiào
超标	chāobiāo
超车	chāochē
超前	chāoqián
超速	chāosù
朝代	cháodài
朝着	cháozhe
嘲弄	cháonòng
嘲笑	cháoxiào
吵嘴	chǎozuǐ
车道	chēdào
车祸	chēhuò
车间	chējiān
车轮	chēlún
车速	chēsù
车位	chēwèi
车厢	chēxiāng
车型	chēxíng
车轴	chēzhóu
扯	chě
彻夜	chèyè
撤	chè
撤换	chèhuàn
沉甸甸	chéndiàndiàn
沉淀	chéndiàn
沉浸	chénjìn
沉闷	chénmèn
沉迷	chénmí
沉思	chénsī
沉稳	chénwěn
沉着	chénzhuó
陈旧	chénjiù
陈列	chénliè
陈述	chénshù
衬托	chèntuō
趁	chèn
趁机	chènjī
趁早	chènzǎo
趁着	chènzháo
称呼	chēnghu
称作	chēngzuò
成才	chéngcái
成家	chéngjiā
成年	chéngnián
成年	chéngnián
成千上万	chéngqiānshàngwàn
成群结队	chéngqúnjiéduì
成天	chéngtiān
成问题	chéngwèntí
成型	chéngxíng
呈现	chéngxiàn
诚恳	chéngkěn
诚心诚意	chéngxīnchéngyì
诚意	chéngyì
诚挚	chéngzhì
承包	chéngbāo
承载	chéngzài
城墙	chéngqiáng
乘人之危	chéngrénzhīwēi
盛	shèng
惩处	chéngchǔ
惩罚	chéngfá
澄清	dèngqīng
橙汁	chéngzhī
逞能	chěngnéng
逞强	chěngqiáng
秤	chèng
吃不上	chībushàng
吃喝玩乐	chīhēwánlè
吃苦	chīkǔ
吃亏	chīkuī
痴呆	chīdāi
痴迷	chīmí
痴心	chīxīn
池塘	chítáng
驰名	chímíng
迟迟	chíchí
迟疑	chíyí
迟早	chízǎo
持	chí
持久	chíjiǔ
持之以恒	chízhīyǐhéng
尺度	chǐdù
耻辱	chǐrǔ
耻笑	chǐxiào
赤字	chìzì
翅膀	chìbǎng
冲刺	chōngcì
冲浪	chōnglàng
冲洗	chōngxǐ
冲撞	chōngzhuàng
充	chōng
充当	chōngdāng
充沛	chōngpèi
充实	chōngshí
重播	chóngbō
重叠	chóngdié
重返	chóngfǎn
重合	chónghé
重申	chóngshēn
重现	chóngxiàn
崇高	chónggāo
崇尚	chóngshàng
宠	chǒng
宠爱	chǒngài
抽签	chōuqiān
抽屉	chōuti
抽象	chōuxiàng
仇	qiú
仇恨	chóuhèn
仇人	chóurén
稠	chóu
稠密	chóumì
愁眉苦脸	chóuméikǔliǎn
筹	chóu
筹办	chóubàn
筹备	chóubèi
筹措	chóucuò
筹划	chóuhuà
筹集	chóují
筹码	chóumǎ
丑恶	chǒuè
丑陋	chǒulòu
丑闻	chǒuwén
瞅	chǒu
出版社	chūbǎnshè
出厂	chūchǎng
出丑	chūchǒu
出道	chū dào
出发点	chūfādiǎn
出风头	chūfēngtou
出境	chūjìng
出局	chūjú
出具	chūjù
出口成章	chūkǒuchéngzhāng
出卖	chūmài
出毛病	chūmáobìng
出难题	chūnántí
出人意料	chūrényìliào
出任	chūrèn
出山	chūshān
出身	chūshēn
出示	chūshì
出手	chūshǒu
出头	chūtóu
出土	chūtǔ
出息	chūxi
出血	chūxuè
出演	chūyǎn
出洋相	chūyángxiàng
出游	chūyóu
出众	chūzhòng
出主意	chū zhǔyi
出资	chūzī
出自	chūzì
出走	chūzǒu
初次	chūcì
初衷	chūzhōng
除此之外	chúcǐzhīwài
除去	chúqù
除外	chúwài
处方	chǔfāng
处境	chǔjìng
处置	chǔzhì
储备	chǔbèi
储蓄	chǔxù
触动	chùdòng
触犯	chùfàn
触觉	chùjué
触摸	chùmō
触目惊心	chùmùjīngxīn
揣	chuāi
揣测	chuǎicè
揣摩	chuǎimó
踹	chuài
川流不息	chuānliúbùxī
穿过	chuānguò
穿小鞋	chuānxiǎoxié
穿越	chuānyuè
穿着	chuānzhuó
传承	chuánchéng
传奇	chuánqí
传染	chuánrǎn
传染病	chuánrǎnbìng
传人	chuánrén
传授	chuánshòu
传闻	chuánwén
船舶	chuánbó
船桨	chuánjiǎng
喘	chuǎn
喘息	chuǎnxī
串门	chuànmén
创伤	chuāngshāng
床位	chuángwèi
创	chuàng
创始人	chuàngshǐrén
吹了	chuī le
吹牛	chuīniú
吹捧	chuīpěng
垂	chuí
垂头丧气	chuítóusàngqì
捶	chuí
锤子	chuízi
纯粹	chúncuì
纯洁	chúnjié
纯朴	chúnpǔ
醇厚	chúnhòu
蠢	chǔn
戳	chuō
绰号	chuòhào
瓷	cí
瓷器	cíqì
辞	cí
辞呈	cíchéng
辞去	cíqù
辞退	cítuì
慈善	císhàn
慈祥	cíxiáng
磁带	cídài
磁卡	cíkǎ
磁盘	cípán
此起彼伏	cǐqǐbǐfú
次日	cìrì
伺候	cìhou
刺耳	cìěr
刺骨	cìgǔ
刺绣	cìxiù
赐	cì
赐教	cìjiào
匆匆	cōngcōng
匆忙	cōngmáng
葱	cōng
从今以后	cóngjīnyǐhòu
从来不	cóngláibù
从容	cóngróng
从容不迫	cóngróngbùpò
从头	cóngtóu
从未	cóngwèi
从业	cóngyè
从早到晚	cóngzǎodàowǎn
丛林	cónglín
凑	còu
凑合	còuhe
凑巧	còuqiǎo
粗暴	cūbào
粗糙	cūcāo
粗鲁	cūlǔ
粗略	cūlüè
粗心大意	cūxīndàyì
促成	cùchéng
簇拥	cùyōng
窜	cuàn
催	cuī
催促	cuīcù
催眠	cuīmián
摧毁	cuīhuǐ
脆弱	cuìruò
翠绿	cuìlǜ
存放	cúnfàng
存心	cúnxīn
存折	cúnzhé
搓	cuō
磋商	cuōshāng
挫折	cuòzhé
措手不及	cuòshǒubùjí
错别字	cuòbiézì
错觉	cuòjué
错位	cuòwèi
错综复杂	cuòzōngfùzá
搭乘	dāchéng
搭建	dājiàn
达标	dábiāo
答辩	dábiàn
打岔	dǎchà
打倒	dǎdǎo
打盹儿	dǎdǔnr
打交道	dǎjiāodào
打搅	dǎjiǎo
打捞	dǎlāo
打量	dǎliang
打猎	dǎliè
打磨	dǎmó
打通	dǎtōng
打仗	dǎzhàng
打招呼	dǎzhāohu
大包大揽	dàbāodàlǎn
大笔	dàbǐ
大臣	dàchén
大吃一惊	dàchīyījīng
大大咧咧	dàdàliēliē
大地	dàdì
大队	dàduì
大幅度	dàfúdù
大公无私	dàgōngwúsī
大家庭	dàjiātíng
大街小巷	dàjiēxiǎoxiàng
大惊小怪	dàjīngxiǎoguài
大局	dàjú
大款	dàkuǎn
大面积	dàmiànjī
大名鼎鼎	dàmíngdǐngdǐng
大模大样	dàmúdàyàng
大棚	dàpéng
大片	dàpiàn
大气	dàqì
大厦	dàshà
大数据	dà shùjù
大肆	dàsì
大体	dàtǐ
大体上	dàtǐshàng
大同小异	dàtóngxiǎoyì
大腕儿	dàwànér
大选	dàxuǎn
大雁	dàyàn
大意	dàyì
大意	dàyì
大有可为	dàyǒukěwéi
大宗	dàzōng
歹徒	dǎitú
逮	dài
代号	dàihào
代理人	dàilǐrén
代言人	dàiyánrén
带队	dàiduì
带路	dàilù
带头	dàitóu
带头人	dàitóurén
待	dài
怠工	dàigōng
怠慢	dàimàn
逮捕	dàibǔ
担	dān
担当	dāndāng
担负	dānfù
单边	dānbiān
单薄	dānbó
单方面	dānfāngmiàn
单身	dānshēn
耽搁	dānge
耽误	dānwu
胆怯	dǎnqiè
胆子	dǎnzi
但愿	dànyuàn
担	dān
担子	dànzi
诞辰	dànchén
淡化	dànhuà
淡季	dànjì
蛋白质	dànbáizhì
当即	dāngjí
当今	dāngjīn
当面	dāngmiàn
当日	dàngrì
当事人	dāngshìrén
当务之急	dāngwùzhījí
当下	dāngxià
当心	dāngxīn
当着	dāngzhe
当之无愧	dāngzhīwúkuì
当众	dāngzhòng
当晚	dàngwǎn
当真	dàngzhēn
荡漾	dàngyàng
档次	dàngcì
导弹	dǎodàn
导航	dǎoháng
导火索	dǎohuǒsuǒ
导师	dǎoshī
导向	dǎoxiàng
岛屿	dǎoyǔ
捣乱	dǎoluàn
倒卖	dǎomài
倒霉	dǎoméi
倒塌	dǎotā
倒下	dǎoxià
到头来	dàotóulái
到位	dàowèi
倒计时	dàojìshí
倒数	dàoshù
盗	dào
盗窃	dàoqiè
悼念	dàoniàn
道具	dàojù
稻草	dàocǎo
得不偿失	débùchángshī
得当	dédàng
得力	délì
得失	déshī
得手	déshǒu
得体	détǐ
得天独厚	détiāndúhòu
得益于	deyìyú
得意扬扬	déyìyángyáng
得知	dézhī
得罪	dézui
德	dé
灯笼	dēnglóng
灯泡	dēngpào
登机	dēngjī
登陆	dēnglù
蹬	dēng
凳子	dèngzi
瞪	dèng
低调	dīdiào
低估	dīgū
低谷	dīgǔ
低价	dījià
低迷	dīmí
低碳	dītàn
低下	dīxià
堤	dī
堤坝	dībà
提防	dīfáng
笛子	dízi
抵触	dǐchù
抵挡	dǐdǎng
抵消	dǐxiāo
抵押	dǐyā
抵御	dǐyù
抵制	dǐzhì
底层	dǐcéng
底线	dǐxiàn
底蕴	dǐyùn
底子	dǐzi
地步	dìbù
地道	dìdao
地道	dìdao
地段	dìduàn
地理	dìlǐ
地毯	dìtǎn
地下水	dìxiàshuǐ
地狱	dìyù
地域	dìyù
地质	dìzhì
弟子	dìzǐ
帝国	dìguó
帝国主义	dìguózhǔyì
递交	dìjiāo
第一手	dìyīshǒu
第一线	dìyīxiàn
颠倒	diāndǎo
颠覆	diānfù
巅峰	diānfēng
典范	diǎnfàn
点火	diǎnhuǒ
点击率	diǎnjīlǜ
点评	diǎnpíng
点心	diǎnxin
点缀	diǎnzhuì
点子	diǎnzi
电报	diànbào
电铃	diànlíng
电网	diànwǎng
电线	diànxiàn
电信	diànxìn
电讯	diànxùn
垫	diàn
垫底	diàndǐ
垫子	diànzi
淀粉	diànfěn
惦记	diànjì
奠定	diàndìng
殿堂	diàntáng
刁难	diāonàn
叼	diāo
雕	diāo
雕刻	diāokè
雕塑	diāosù
吊销	diàoxiāo
钓鱼	diàoyú
调度	diàodù
掉队	diàoduì
掉头	diàotóu
爹	diē
迭起	diéqǐ
叠	dié
丁	dīng
叮嘱	dīngzhǔ
盯	dīng
钉子	dīngzi
顶多	dǐngduō
顶级	dǐngjí
顶尖	dǐngjiān
订单	dìngdān
订购	dìnggòu
订婚	dìnghūn
订立	dìnglì
钉	dīng
定金	dìngjīn
定居	dìngjū
定论	dìnglùn
定为	dìngwèi
定向	dìngxiàng
定心丸	dìngxīnwán
定义	dìngyì
定做	dìngzuò
丢掉	diūdiào
丢脸	diūliǎn
丢弃	diūqì
丢人	diūrén
丢失	diūshī
东奔西走	dōngbēnxīzǒu
东道主	dōngdàozhǔ
东张西望	dōngzhāngxīwàng
董事	dǒngshì
董事会	dǒngshìhuì
董事长	dǒngshìzhǎng
懂事	dǒngshì
动不动	dòngbudòng
动荡	dòngdàng
动感	dònggǎn
动工	dònggōng
动静	dòngjìng
动脉	dòngmài
动身	dòngshēn
动弹	dòngtan
动听	dòngtīng
动向	dòngxiàng
动用	dòngyòng
冻结	dòngjié
栋	dòng
栋梁	dòngliáng
兜	dōu
兜儿	dōur
兜售	dōushòu
抖	dǒu
陡	dǒu
斗	dòu
斗志	dòuzhì
豆浆	dòujiāng
豆子	dòuzi
逗	dòu
都会	dōu huì
督促	dūcù
独	dú
独唱	dúchàng
独家	dújiā
独立自主	dúlìzìzhǔ
独身	dúshēn
独一无二	dúyīwúèr
堵塞	dǔsè
杜绝	dùjué
妒忌	dùjì
度	dù
度假	dùjià
渡过	dùguò
端正	duānzhèng
短缺	duǎnquē
短暂	duǎnzàn
段落	duànluò
断定	duàndìng
断断续续	duànduànxùxù
断裂	duànliè
堆砌	duīqì
队形	duìxíng
对白	duìbái
对策	duìcè
对称	duìchèn
对得起	duìdeqǐ
对联	duìlián
对弈	duìyì
对照	duìzhào
对峙	duìzhì
对准	duìzhǔn
兑换	duìhuàn
兑现	duìxiàn
敦促	dūncù
敦厚	dūnhòu
炖	dùn
顿时	dùnshí
多边	duōbiān
多功能	duōgōngnéng
多亏	duōkuī
多劳多得	duōláoduōdé
多年来	duōnián lái
多心	duōxīn
多余	duōyú
多元	duōyuán
哆嗦	duōsuo
夺冠	duóguàn
夺魁	duókuí
躲避	duǒbì
躲藏	duǒcáng
舵手	duòshǒu
堕落	duòluò
讹诈	ézhà
俄语	éyǔ
鹅	é
额外	éwài
厄运	èyùn
恶	è
恶化	èhuà
恶劣	èliè
恶性	èxìng
恶意	èyì
遏制	èzhì
鳄鱼	èyú
恩赐	ēncì
恩惠	ēnhuì
恩情	ēnqíng
恩怨	ēnyuàn
而已	éryǐ
耳光	ěrguāng
耳目一新	ěrmùyīxīn
耳熟能详	ěrshúnéngxiáng
耳闻目睹	ěrwénmùdǔ
二手车	èrshǒuchē
二氧化碳	èryǎnghuàtàn
发布会	fābùhuì
发财	fācái
发愁	fāchóu
发电机	fādiànjī
发抖	fādǒu
发愤图强	fāfèntúqiáng
发光	fāguāng
发火	fāhuǒ
发酵	fājiào
发掘	fājué
发愣	fālèng
发脾气	fāpíqì
发起人	fāqǐrén
发热	fārè
发誓	fāshì
发泄	fāxiè
发扬	fāyáng
发扬光大	fāyángguāngdà
发育	fāyù
发源地	fāyuándì
发作	fāzuò
阀门	fámén
发型	fàxíng
帆	fān
帆船	fānchuán
翻番	fānfān
翻来覆去	fānláifùqù
翻天覆地	fāntiānfùdì
凡	fán
烦闷	fánmèn
烦恼	fánnǎo
烦躁	fánzào
繁华	fánhuá
繁忙	fánmáng
繁体字	fántǐzì
繁重	fánzhòng
反驳	fǎnbó
反差	fǎnchā
反常	fǎncháng
反倒	fǎndào
反感	fǎngǎn
反过来	fǎnguolái
反击	fǎnjī
反馈	fǎnkuì
反面	fǎnmiàn
反思	fǎnsī
反弹	fǎndàn
反省	fǎnxǐng
返还	fǎnhuán
犯愁	fànchóu
饭碗	fànwǎn
泛滥	fànlàn
范畴	fànchóu
贩卖	fànmài
方方面面	fāngfāngmiànmiàn
方向盘	fāngxiàngpán
方言	fāngyán
防盗	fángdào
防盗门	fángdàomén
防护	fánghù
防火墙	fánghuǒqiáng
防卫	fángwèi
防汛	fángxùn
防疫	fángyì
防御	fángyù
妨碍	fángài
妨害	fánghài
房地产	fángdìchǎn
仿	fǎng
仿制	fǎngzhì
访谈	fǎngtán
纺织	fǎngzhī
放过	fàngguò
放水	fàngshuǐ
放肆	fàngsì
放映	fàngyìng
放置	fàngzhì
放纵	fàngzòng
飞速	fēisù
飞往	fēiwǎng
飞翔	fēixiáng
飞跃	fēiyuè
非	fēi
非得	fēiděi
非法	fēifǎ
非凡	fēifán
绯闻	fēiwén
肥料	féiliào
肥胖	féipàng
肥沃	féiwò
肥皂	féizào
诽谤	fěibàng
废	fèi
废除	fèichú
废话	fèihuà
废品	fèipǐn
废寝忘食	fèiqǐnwàngshí
废物	fèiwù
废墟	fèixū
沸沸扬扬	fèifèiyángyáng
沸腾	fèiténg
费劲	fèijìn
分辨	fēnbiàn
分寸	fēncùn
分担	fēndān
分割	fēngē
分红	fēnhóng
分化	fēnhuà
分泌	fēnmì
分明	fēnmíng
分歧	fēnqí
分赃	fēnzāng
分支	fēnzhī
芬芳	fēnfāng
吩咐	fēnfù
氛围	fēnwéi
坟	fén
坟墓	fénmù
焚烧	fénshāo
粉	fěn
粉丝	fěnsī
粉碎	fěnsuì
分量	fènliang
分外	fènwài
份额	fèné
奋力	fènlì
奋勇	fènyǒng
粪	fèn
粪便	fènbiàn
丰富多彩	fēngfùduōcǎi
丰厚	fēnghòu
丰满	fēngmǎn
丰盛	fēngshèng
丰硕	fēngshuò
风波	fēngbō
风采	fēngcǎi
风餐露宿	fēngcānlùsù
风范	fēngfàn
风风雨雨	fēngfēngyǔyǔ
风和日丽	fēnghérìlì
风浪	fēnglàng
风力	fēnglì
风流	fēngliú
风貌	fēngmào
风气	fēngqì
风情	fēngqíng
风趣	fēngqù
风沙	fēngshā
风尚	fēngshàng
风水	fēngshuǐ
风味	fēngwèi
风雨	fēngyǔ
风云	fēngyún
风筝	fēngzhēng
封顶	fēngdǐng
封建	fēngjiàn
封面	fēngmiàn
封锁	fēngsuǒ
疯子	fēngzi
峰回路转	fēnghuílùzhuǎn
蜂蜜	fēngmì
逢	féng
缝	féng
缝合	fènghé
讽刺	fěngcì
凤凰	fènghuáng
缝	féng
否决	fǒujué
孵化	fūhuà
敷	fū
扶持	fúchí
服饰	fúshì
服务器	fúwùqì
服用	fúyòng
俘获	fúhuò
俘虏	fúlǔ
浮力	fúlì
浮现	fúxiàn
浮躁	fúzào
辐射	fúshè
福气	fúqi
抚摸	fǔmō
抚恤	fǔxù
抚养	fǔyǎng
抚养费	fǔyǎngfèi
斧子	fǔzi
俯首	fǔshǒu
辅导	fǔdǎo
腐败	fǔbài
腐化	fǔhuà
腐烂	fǔlàn
腐蚀	fǔshí
腐朽	fǔxiǔ
付费	fùfèi
付款	fùkuǎn
负面	fùmiàn
负有	fùyǒu
附	fù
附带	fùdài
附和	fùhè
附加	fùjiā
附属	fùshǔ
赴	fù
复查	fùchá
复发	fùfā
复合	fùhé
复活	fùhuó
复兴	fùxīng
复原	fùyuán
副作用	fùzuòyòng
赋予	fùyǔ
富含	fùhán
富豪	fùháo
富强	fùqiáng
富翁	fùwēng
富裕	fùyù
富足	fùzú
腹部	fùbù
腹泻	fùxiè
覆盖	fùgài
该	gāi
改版	gǎibǎn
改编	gǎibiān
改动	gǎidòng
改革开放	gǎigékāifàng
改良	gǎiliáng
改名	gǎimíng
改日	gǎirì
改为	gǎiwéi
改邪归正	gǎixiéguīzhèng
钙	gài
盖子	gàizi
概况	gàikuàng
概率	gàilǜ
概论	gàilùn
干戈	gāngē
干旱	gānhàn
干燥	gānzào
甘心	gānxīn
肝脏	gānzàng
尴尬	gāngà
赶赴	gǎnfù
赶往	gǎnwǎng
敢情	gǎnqing
感	gǎn
感触	gǎnchù
感恩	gǎnēn
感激	gǎnjī
感慨	gǎnkǎi
感染	gǎnrǎn
感染力	gǎnrǎnlì
感叹	gǎntàn
感性	gǎnxìng
干部	gànbù
干事	gànshi
刚毅	gāngyì
纲领	gānglǐng
纲要	gāngyào
钢	gāng
缸	gāng
港	gǎng
杠铃	gànglíng
高昂	gāoáng
高傲	gāoào
高超	gāochāo
高低	gāodī
高调	gāodiào
高额	gāoé
高尔夫球	gāoěrfūqiú
高峰期	gāofēngqī
高贵	gāoguì
高空	gāokōng
高龄	gāolíng
高明	gāomíng
高山	gāoshān
高效	gāoxiào
高新技术	gāoxīnjìshù
高血压	gāoxuèyā
高压	gāoyā
高雅	gāoyǎ
高涨	gāozhǎng
搞鬼	gǎoguǐ
搞笑	gǎoxiào
告	gào
告辞	gàocí
告诫	gàojiè
告示	gàoshi
告知	gàozhī
告状	gàozhuàng
戈壁	gēbì
胳膊	gēbo
鸽子	gēzi
搁	gē
搁浅	gēqiǎn
搁置	gēzhì
割	gē
歌剧	gējù
歌颂	gēsòng
歌舞	gēwǔ
歌咏	gēyǒng
革命	gémìng
格	gé
格格不入	gégébùrù
格局	géjú
格式	géshì
隔阂	géhé
隔离	gélí
个案	gèàn
个头儿	gètóur
各奔前程	gèbènqiánchéng
各式各样	gèshìgèyàng
根基	gēnjī
根深蒂固	gēnshēndìgù
根源	gēnyuán
根治	gēnzhì
跟不上	gēnbushàng
跟上	gēnshàng
跟踪	gēnzōng
更改	gēnggǎi
更衣室	gēngyīshì
耕地	gēngdì
耿直	gěngzhí
工地	gōngdì
工会	gōnghuì
工科	gōngkē
工商界	gōngshāngjiè
工序	gōngxù
工整	gōngzhěng
工作量	gōngzuòliàng
弓	gōng
公安局	gōngānjú
公车	gōngchē
公道	gōngdao
公费	gōngfèi
公共场所	gōnggòngchǎngsuǒ
公关	gōngguān
公函	gōnghán
公积金	gōngjījīn
公开信	gōngkāixìn
公款	gōngkuǎn
公立	gōnglì
公墓	gōngmù
公仆	gōngpú
公顷	gōngqǐng
公然	gōngrán
公示	gōngshì
公事	gōngshì
公务	gōngwù
公益	gōngyì
公益性	gōngyìxìng
公用	gōngyòng
公寓	gōngyù
公约	gōngyuē
公证	gōngzhèng
公职	gōngzhí
功	gōng
功臣	gōngchén
功底	gōngdǐ
功劳	gōngláo
功力	gōnglì
功率	gōnglǜ
功效	gōngxiào
攻	gōng
攻读	gōngdú
攻关	gōngguān
供	gōng
供不应求	gōngbùyìngqiú
供暖	gōngnuǎn
供求	gōngqiú
宫殿	gōngdiàn
宫廷	gōngtíng
恭维	gōngwei
恭喜	gōngxǐ
拱	gǒng
共鸣	gòngmíng
共识	gòngshí
共同体	gòngtóngtǐ
共性	gòngxìng
供奉	gòngfèng
勾	gōu
勾画	gōuhuà
勾结	gōujié
钩	gōu
钩子	gōuzi
构思	gòusī
构想	gòuxiǎng
购	gòu
够呛	gòuqiàng
估算	gūsuàn
沽名钓誉	gūmíngdiàoyù
孤单	gūdān
孤立	gūlì
孤零零	gūlínglíng
孤陋寡闻	gūlòuguǎwén
辜负	gūfù
古董	gǔdǒng
古怪	gǔguài
古迹	gǔjì
古今中外	gǔjīnzhōngwài
古朴	gǔpǔ
古人	gǔrén
股份	gǔfèn
股民	gǔmín
股市	gǔshì
骨干	gǔgàn
骨气	gǔqì
骨折	gǔzhé
鼓动	gǔdòng
鼓舞	gǔwǔ
固然	gùrán
固执	gùzhí
故	gù
顾不得	gùbude
顾不上	gùbushàng
顾及	gùjí
顾虑	gùlǜ
顾全大局	gùquándàjú
雇	gù
雇佣	gùyōng
雇员	gùyuán
雇主	gùzhǔ
瓜分	guāfēn
瓜子	guāzǐ
刮风	guāfēng
寡妇	guǎfu
挂钩	guàgōu
挂号	guàhào
挂念	guàniàn
挂失	guàshī
乖	guāi
乖巧	guāiqiǎo
拐弯	guǎiwān
拐杖	guǎizhàng
怪不得	guàibude
怪物	guàiwù
怪异	guàiyì
关掉	guāndiào
关节	guānjié
关税	guānshuì
关头	guāntóu
关照	guānzhào
观测	guāncè
观感	guāngǎn
观摩	guānmó
观赏	guānshǎng
观望	guānwàng
官兵	guānbīng
官吏	guānlì
官僚	guānliáo
官僚主义	guānliáozhǔyì
官员	guānyuán
棺材	guāncai
管家	guǎnjiā
管教	guǎnjiào
管理费	guǎnlǐfèi
管辖	guǎnxiá
管用	guǎnyòng
管子	guǎnzi
贯彻	guànchè
贯穿	guànchuān
贯通	guàntōng
惯	guàn
惯例	guànlì
惯性	guànxìng
灌	guàn
灌溉	guàngài
灌输	guànshū
罐	guàn
罐头	guàntou
光彩	guāngcǎi
光碟	guāngdié
光顾	guānggù
光滑	guānghuá
光环	guānghuán
光缆	guānglǎn
光芒	guāngmáng
光明磊落	guāngmínglěiluò
光泽	guāngzé
广义	guǎngyì
归根到底	guīgēndàodǐ
归还	guīhuán
归结	guījié
归来	guīlái
归纳	guīnà
归属	guīshǔ
归宿	guīsù
龟	guī
规格	guīgé
规矩	guīju
闺女	guīnǚ
瑰宝	guībǎo
轨迹	guǐjì
柜台	guìtái
贵宾	guìbīn
贵重	guìzhòng
贵族	guìzú
桂花	guìhuā
滚动	gǔndòng
棍	gùn
棍子	gùnzi
国宝	guóbǎo
国防	guófáng
国画	guóhuà
国徽	guóhuī
国情	guóqíng
国土	guótǔ
国学	guóxué
国有	guóyǒu
果断	guǒduàn
果园	guǒyuán
果真	guǒzhēn
裹	guǒ
过半	guòbàn
过不去	guòbuqù
过错	guòcuò
过道	guò dào
过关	guòguān
过奖	guòjiǎng
过节	guòjié
过境	guòjìng
过滤	guòlǜ
过期	guòqī
过日子	guòrìzi
过剩	guòshèng
过失	guòshī
过头	guò​tóu
过往	guòwǎng
过意不去	guòyìbùqù
过瘾	guòyǐn
过硬	guòyìng
过早	guòzǎo
海岸	hǎiàn
海拔	hǎibá
海滨	hǎibīn
海盗	hǎidào
海量	hǎiliàng
海绵	hǎimián
海面	hǎimiàn
海内外	hǎinèiwài
海滩	hǎitān
海峡	hǎixiá
海啸	hǎixiào
海域	hǎiyù
海运	hǎiyùn
海藻	hǎizǎo
骇人听闻	hàiréntīngwén
害虫	hàichóng
害臊	hàisào
害羞	hàixiū
酣畅	hānchàng
酣睡	hānshuì
含糊	hánhu
含蓄	hánxù
函授	hánshòu
涵盖	hángài
涵义	hányì
罕见	hǎnjiàn
汗水	hànshuǐ
旱	hàn
旱灾	hànzāi
捍卫	hànwèi
焊	hàn
行家	hángjiā
行列	hángliè
行情	hángqíng
航海	hánghǎi
航天	hángtiān
航天员	hángtiānyuán
航行	hángxíng
航运	hángyùn
毫不	háobù
毫不犹豫	háobùyóuyù
毫无	háowú
豪华	háohuá
好比	hǎobǐ
好歹	hǎodǎi
好感	hǎogǎn
好坏	hǎohuài
好家伙	hǎojiāhuo
好评	hǎopíng
好说	hào shuō
好笑	hǎoxiào
好心	hǎoxīn
好心人	hǎoxīnrén
好意	hǎoyì
好在	hào zài
号称	hàochēng
好客	hàokè
好奇心	hàoqíxīn
耗	hào
耗费	hàofèi
耗时	hàoshí
浩劫	hàojié
呵护	hēhù
禾苗	hémiáo
合唱	héchàng
合乎	héhū
合伙	héhuǒ
合计	héjì
合情合理	héqínghélǐ
合影	héyǐng
合资	hézī
合作社	hézuòshè
何必	hébì
何处	héchù
何苦	hékǔ
何况	hékuàng
何时	héshí
和蔼	héǎi
和解	héjiě
和睦	hémù
和平共处	hépínggòngchǔ
和气	hé qì
和尚	héshang
河流	héliú
河畔	hépàn
荷花	héhuā
核	hé
核电站	hédiànzhàn
核对	héduì
核能	hénéng
核实	héshí
核桃	hétao
核武器	héwǔqì
贺电	hèdiàn
贺信	hèxìn
喝彩	hècǎi
赫然	hèrán
鹤立鸡群	hèlìjīqún
黑白	hēi​bái
黑客	hēikè
黑马	hēimǎ
黑手	hēishǒu
黑心	hēixīn
嘿	hēi
痕迹	hénjì
恨不得	hènbude
哼	hēng
横七竖八	héngqīshùbā
横向	héngxiàng
横	héng, hèng
轰	hōng
轰动	hōngdòng
轰炸	hōngzhà
哄	hòng
哄堂大笑	hōngtángdàxiào
烘干	hōnggān
烘托	hōngtuō
弘扬	hóngyáng
红灯	hóngdēng
红火	hónghuǒ
红扑扑	hóngpūpū
红润	hóngrùn
红薯	hóngshǔ
红眼	hóngyǎn
宏观	hóngguān
宏伟	hóngwěi
洪亮	hóngliàng
哄	hōng, hǒng, hòng
喉咙	hóulóng
吼	hǒu
后备	#NAME?
后备箱	#NAME?
后代	#NAME?
后盾	#NAME?
后顾之忧	#NAME?
后期	#NAME?
后勤	#NAME?
后人	#NAME?
后台	#NAME?
后退	#NAME?
后续	#NAME?
后遗症	#NAME?
后裔	#NAME?
后者	#NAME?
厚道	#NAME?
厚度	#NAME?
候选人	#NAME?
呼风唤雨	#NAME?
呼唤	#NAME?
呼救	#NAME?
呼声	#NAME?
呼应	#NAME?
呼吁	#NAME?
忽高忽低	#NAME?
忽悠	#NAME?
胡闹	#NAME?
胡说	#NAME?
胡思乱想	#NAME?
湖泊	#NAME?
糊	#NAME?
糊涂	#NAME?
互补	#NAME?
互访	#NAME?
互信	#NAME?
互助	#NAME?
护理	#NAME?
花瓣	#NAME?
花卉	#NAME?
花纹	#NAME?
花样	#NAME?
划算	#NAME?
华丽	#NAME?
华侨	#NAME?
华裔	#NAME?
哗变	#NAME?
哗然	#NAME?
滑冰	#NAME?
滑稽	#NAME?
滑梯	#NAME?
滑雪	#NAME?
化肥	#NAME?
化身	#NAME?
化纤	#NAME?
化险为夷	#NAME?
化验	#NAME?
化妆	#NAME?
划时代	#NAME?
画册	#NAME?
画龙点睛	#NAME?
画蛇添足	#NAME?
画展	#NAME?
话费	#NAME?
话筒	#NAME?
话语	#NAME?
怀抱	#NAME?
怀旧	#NAME?
怀里	#NAME?
怀孕	#NAME?
怀着	#NAME?
槐树	#NAME?
坏事	#NAME?
欢呼	#NAME?
欢聚	#NAME?
欢快	#NAME?
欢声笑语	#NAME?
还款	#NAME?
还原	#NAME?
环球	#NAME?
环绕	#NAME?
缓	#NAME?
缓和	#NAME?
缓缓	#NAME?
缓慢	#NAME?
幻觉	#NAME?
幻影	#NAME?
换成	#NAME?
换取	#NAME?
换位	#NAME?
换言之	#NAME?
唤起	#NAME?
患	#NAME?
患病	#NAME?
患有	#NAME?
焕发	#NAME?
荒	#NAME?
荒诞	#NAME?
荒凉	#NAME?
荒谬	#NAME?
慌乱	#NAME?
慌张	#NAME?
皇宫	#NAME?
皇后	#NAME?
皇上	#NAME?
皇室	#NAME?
黄昏	#NAME?
恍然大悟	#NAME?
晃	#NAME?
谎话	#NAME?
谎言	#NAME?
晃	#NAME?
晃荡	#NAME?
灰	#NAME?
灰尘	#NAME?
灰心	#NAME?
挥	#NAME?
辉煌	#NAME?
回归	#NAME?
回扣	#NAME?
回馈	#NAME?
回落	#NAME?
回升	#NAME?
回首	#NAME?
回味	#NAME?
回想	#NAME?
回忆录	#NAME?
悔恨	#NAME?
毁坏	#NAME?
毁灭	#NAME?
汇合	#NAME?
汇集	#NAME?
汇聚	#NAME?
会场	#NAME?
会面	#NAME?
会晤	#NAME?
会意	#NAME?
会诊	#NAME?
绘声绘色	#NAME?
贿赂	#NAME?
昏迷	#NAME?
婚纱	#NAME?
婚姻	#NAME?
浑身	#NAME?
魂	#NAME?
混凝土	#NAME?
混淆	#NAME?
混浊	#NAME?
豁	#NAME?
豁出去	#NAME?
活该	#NAME?
活期	#NAME?
活儿	#NAME?
火暴	#NAME?
火锅	#NAME?
火候	#NAME?
火花	#NAME?
火炬	#NAME?
火辣辣	#NAME?
火热	#NAME?
火山	#NAME?
火速	#NAME?
火焰	#NAME?
火药	#NAME?
伙食	#NAME?
或多或少	#NAME?
货币	#NAME?
货车	#NAME?
货物	#NAME?
货运	#NAME?
获胜	#NAME?
获悉	#NAME?
祸害	#NAME?
霍乱	#NAME?
豁达	#NAME?
几率	#NAME?
讥笑	#NAME?
饥饿	#NAME?
机舱	#NAME?
机动	#NAME?
机灵	#NAME?
机密	#NAME?
机智	#NAME?
肌肤	#NAME?
积	#NAME?
积淀	#NAME?
积蓄	#NAME?
基本功	#NAME?
基层	#NAME?
基因	#NAME?
基于	#NAME?
基准	#NAME?
畸形	#NAME?
激发	#NAME?
激光	#NAME?
激化	#NAME?
激活	#NAME?
激励	#NAME?
激起	#NAME?
激素	#NAME?
及	#NAME?
及其	#NAME?
及早	#NAME?
吉普	#NAME?
吉他	#NAME?
吉祥物	#NAME?
级别	#NAME?
极度	#NAME?
极力	#NAME?
极少数	#NAME?
极为	#NAME?
极限	#NAME?
即	#NAME?
即便	#NAME?
即可	#NAME?
急剧	#NAME?
急迫	#NAME?
急性	#NAME?
急需	#NAME?
急于	#NAME?
急诊	#NAME?
急转弯	#NAME?
棘手	#NAME?
集会	#NAME?
集结	#NAME?
集邮	#NAME?
集装箱	#NAME?
集资	#NAME?
嫉妒	#NAME?
挤压	#NAME?
脊梁	#NAME?
计	#NAME?
计策	#NAME?
计较	#NAME?
计时	#NAME?
记号	#NAME?
记忆犹新	#NAME?
纪录片	#NAME?
纪念碑	#NAME?
纪念馆	#NAME?
纪念日	#NAME?
纪实	#NAME?
技艺	#NAME?
忌	#NAME?
忌讳	#NAME?
忌口	#NAME?
剂	#NAME?
迹象	#NAME?
继	#NAME?
继而	#NAME?
继父	#NAME?
继母	#NAME?
祭	#NAME?
祭奠	#NAME?
祭祀	#NAME?
寄托	#NAME?
寂静	#NAME?
寂寞	#NAME?
加紧	#NAME?
加剧	#NAME?
加深	#NAME?
加重	#NAME?
佳节	#NAME?
家伙	#NAME?
家家户户	#NAME?
家教	#NAME?
家境	#NAME?
家禽	#NAME?
家用	#NAME?
家喻户晓	#NAME?
家政	#NAME?
家族	#NAME?
嘉年华	#NAME?
假定	#NAME?
假冒	#NAME?
假设	#NAME?
假使	#NAME?
假装	#NAME?
价位	#NAME?
价值观	#NAME?
驾	#NAME?
驾车	#NAME?
驾驭	#NAME?
架势	#NAME?
架子	#NAME?
嫁	#NAME?
嫁妆	#NAME?
尖端	#NAME?
尖锐	#NAME?
奸诈	#NAME?
歼灭	#NAME?
坚持不懈	#NAME?
坚韧	#NAME?
坚实	#NAME?
坚守	#NAME?
坚信	#NAME?
坚硬	#NAME?
肩膀	#NAME?
肩负	#NAME?
艰巨	#NAME?
艰苦奋斗	#NAME?
艰险	#NAME?
艰辛	#NAME?
监察	#NAME?
监管	#NAME?
监护	#NAME?
监控	#NAME?
监视	#NAME?
监狱	#NAME?
兼	#NAME?
兼顾	#NAME?
兼任	#NAME?
兼容	#NAME?
兼职	#NAME?
煎	#NAME?
拣	#NAME?
检察	#NAME?
检讨	#NAME?
减免	#NAME?
减弱	#NAME?
减速	#NAME?
减压	#NAME?
简称	#NAME?
简短	#NAME?
简化	#NAME?
简洁	#NAME?
简陋	#NAME?
简体字	#NAME?
简要	#NAME?
简易	#NAME?
见解	#NAME?
见钱眼开	#NAME?
见仁见智	#NAME?
见识	#NAME?
见外	#NAME?
见效	#NAME?
见义勇为	#NAME?
见证	#NAME?
间谍	#NAME?
间断	#NAME?
间隔	#NAME?
间隙	#NAME?
建交	#NAME?
建树	#NAME?
建筑师	#NAME?
建筑物	#NAME?
贱	#NAME?
健美	#NAME?
健壮	#NAME?
溅	#NAME?
鉴别	#NAME?
鉴赏	#NAME?
鉴于	#NAME?
姜	#NAME?
僵	#NAME?
僵化	#NAME?
僵局	#NAME?
讲解	#NAME?
讲述	#NAME?
讲学	#NAME?
奖杯	#NAME?
奖牌	#NAME?
奖品	#NAME?
奖项	#NAME?
降临	#NAME?
交叉	#NAME?
交锋	#NAME?
交付	#NAME?
交集	#NAME?
交接	#NAME?
交界	#NAME?
交纳	#NAME?
交情	#NAME?
交涉	#NAME?
交谈	#NAME?
交替	#NAME?
交头接耳	#NAME?
交响乐	#NAME?
郊外	#NAME?
郊游	#NAME?
浇	#NAME?
娇惯	#NAME?
娇气	#NAME?
胶囊	#NAME?
胶片	#NAME?
焦	#NAME?
焦急	#NAME?
焦距	#NAME?
焦虑	#NAME?
焦躁	#NAME?
礁石	#NAME?
嚼	#NAME?
角落	#NAME?
狡猾	#NAME?
绞	#NAME?
矫正	#NAME?
搅	#NAME?
搅拌	#NAME?
缴	#NAME?
缴费	#NAME?
缴纳	#NAME?
叫板	#NAME?
叫好	#NAME?
轿车	#NAME?
较劲	#NAME?
较量	#NAME?
教科书	#NAME?
教条	#NAME?
教养	#NAME?
阶层	#NAME?
阶级	#NAME?
阶梯	#NAME?
皆	#NAME?
结	#NAME?
结果	#NAME?
接班	#NAME?
接班人	#NAME?
接二连三	#NAME?
接轨	#NAME?
接济	#NAME?
接见	#NAME?
接力	#NAME?
接纳	#NAME?
接手	#NAME?
接送	#NAME?
接替	#NAME?
接听	#NAME?
接通	#NAME?
揭发	#NAME?
揭露	#NAME?
揭示	#NAME?
揭晓	#NAME?
节俭	#NAME?
节气	#NAME?
节水	#NAME?
节衣缩食	#NAME?
劫	#NAME?
劫持	#NAME?
洁净	#NAME?
结冰	#NAME?
结晶	#NAME?
结局	#NAME?
结识	#NAME?
结尾	#NAME?
截	#NAME?
截然不同	#NAME?
竭尽全力	#NAME?
竭力	#NAME?
解答	#NAME?
解读	#NAME?
解雇	#NAME?
解救	#NAME?
解剖	#NAME?
解散	#NAME?
解体	#NAME?
解脱	#NAME?
解围	#NAME?
解析	#NAME?
介入	#NAME?
介意	#NAME?
介于	#NAME?
戒备	#NAME?
戒烟	#NAME?
戒指	#NAME?
届时	#NAME?
界定	#NAME?
界限	#NAME?
界线	#NAME?
借口	#NAME?
借条	#NAME?
借用	#NAME?
借助	#NAME?
金属	#NAME?
金子	#NAME?
金字塔	#NAME?
津津有味	#NAME?
津贴	#NAME?
筋	#NAME?
禁不住	#NAME?
仅次于	#NAME?
尽	#NAME?
尽早	#NAME?
紧凑	#NAME?
紧接着	#NAME?
紧迫	#NAME?
紧缺	#NAME?
紧缩	#NAME?
锦旗	#NAME?
谨慎	#NAME?
尽情	#NAME?
尽头	#NAME?
进场	#NAME?
进程	#NAME?
进出	#NAME?
进出口	#NAME?
进度	#NAME?
进而	#NAME?
进修	#NAME?
近年来	#NAME?
劲头	#NAME?
晋升	#NAME?
浸泡	#NAME?
禁忌	#NAME?
禁区	#NAME?
茎	#NAME?
经	#NAME?
经度	#NAME?
经久不息	#NAME?
经贸	#NAME?
经商	#NAME?
经受	#NAME?
荆棘	#NAME?
惊	#NAME?
惊诧	#NAME?
惊慌	#NAME?
惊慌失措	#NAME?
惊奇	#NAME?
惊叹	#NAME?
惊天动地	#NAME?
惊险	#NAME?
惊心动魄	#NAME?
惊醒	#NAME?
惊讶	#NAME?
晶莹	#NAME?
兢兢业业	#NAME?
精打细算	#NAME?
精华	#NAME?
精简	#NAME?
精练	#NAME?
精妙	#NAME?
精明	#NAME?
精疲力竭	#NAME?
精确	#NAME?
精神病	#NAME?
精髓	#NAME?
精通	#NAME?
精细	#NAME?
精心	#NAME?
精益求精	#NAME?
精英	#NAME?
精致	#NAME?
颈部	#NAME?
景观	#NAME?
景区	#NAME?
警车	#NAME?
警官	#NAME?
警惕	#NAME?
警钟	#NAME?
净化	#NAME?
竞技	#NAME?
竞相	#NAME?
竞选	#NAME?
竟	#NAME?
竟敢	#NAME?
敬	#NAME?
敬爱	#NAME?
敬而远之	#NAME?
敬酒	#NAME?
敬礼	#NAME?
敬佩	#NAME?
敬请	#NAME?
敬业	#NAME?
敬意	#NAME?
敬重	#NAME?
静止	#NAME?
境地	#NAME?
境界	#NAME?
境内	#NAME?
境外	#NAME?
境遇	#NAME?
窘迫	#NAME?
纠缠	#NAME?
揪	#NAME?
久违	#NAME?
久仰	#NAME?
酒精	#NAME?
酒楼	#NAME?
救护车	#NAME?
救济	#NAME?
救治	#NAME?
就餐	#NAME?
就地	#NAME?
就读	#NAME?
就近	#NAME?
就任	#NAME?
就医	#NAME?
就诊	#NAME?
就职	#NAME?
就座	#NAME?
舅舅	#NAME?
拘留	#NAME?
拘束	#NAME?
居高临下	#NAME?
居民楼	#NAME?
鞠躬	#NAME?
局部	#NAME?
局势	#NAME?
局限	#NAME?
菊花	#NAME?
橘子	#NAME?
沮丧	#NAME?
举报	#NAME?
举措	#NAME?
举例	#NAME?
举世闻名	#NAME?
举世无双	#NAME?
举世瞩目	#NAME?
举一反三	#NAME?
举止	#NAME?
举重	#NAME?
巨额	#NAME?
巨人	#NAME?
巨头	#NAME?
巨星	#NAME?
巨型	#NAME?
剧烈	#NAME?
剧目	#NAME?
剧情	#NAME?
剧团	#NAME?
剧院	#NAME?
剧组	#NAME?
据此	#NAME?
据悉	#NAME?
距	#NAME?
锯	#NAME?
聚集	#NAME?
聚精会神	#NAME?
捐献	#NAME?
卷入	#NAME?
卷子	#NAME?
圈	#NAME?
决议	#NAME?
诀别	#NAME?
诀窍	#NAME?
角逐	#NAME?
觉醒	#NAME?
绝技	#NAME?
绝缘	#NAME?
绝招	#NAME?
倔强	#NAME?
崛起	#NAME?
爵士	#NAME?
倔	#NAME?
军官	#NAME?
均衡	#NAME?
均匀	#NAME?
君子	#NAME?
俊	#NAME?
俊俏	#NAME?
骏马	#NAME?
竣工	#NAME?
卡车	#NAME?
卡片	#NAME?
卡通	#NAME?
开办	#NAME?
开采	#NAME?
开场	#NAME?
开场白	#NAME?
开除	#NAME?
开动	#NAME?
开发区	#NAME?
开发商	#NAME?
开工	#NAME?
开垦	#NAME?
开口	#NAME?
开阔	#NAME?
开朗	#NAME?
开辟	#NAME?
开启	#NAME?
开枪	#NAME?
开天辟地	#NAME?
开拓	#NAME?
开销	#NAME?
开张	#NAME?
开支	#NAME?
凯歌	#NAME?
楷模	#NAME?
刊登	#NAME?
刊物	#NAME?
看护	#NAME?
勘探	#NAME?
堪称	#NAME?
侃大山	#NAME?
砍	#NAME?
看得出	#NAME?
看热闹	#NAME?
看似	#NAME?
看台	#NAME?
看样子	#NAME?
看中	#NAME?
看重	#NAME?
慷慨	#NAME?
扛	#NAME?
抗衡	#NAME?
抗拒	#NAME?
抗生素	#NAME?
抗争	#NAME?
考量	#NAME?
烤	#NAME?
靠拢	#NAME?
苛刻	#NAME?
科幻	#NAME?
科目	#NAME?
科普	#NAME?
磕	#NAME?
壳	#NAME?
咳嗽	#NAME?
可悲	#NAME?
可不是	#NAME?
可乘之机	#NAME?
可耻	#NAME?
可歌可泣	#NAME?
可观	#NAME?
可贵	#NAME?
可口	#NAME?
可谓	#NAME?
可恶	#NAME?
可想而知	#NAME?
可笑	#NAME?
可信	#NAME?
可行	#NAME?
可疑	#NAME?
克隆	#NAME?
克制	#NAME?
刻苦	#NAME?
刻意	#NAME?
刻舟求剑	#NAME?
客房	#NAME?
客机	#NAME?
客流	#NAME?
客运	#NAME?
恳求	#NAME?
啃	#NAME?
坑	#NAME?
空荡荡	#NAME?
空难	#NAME?
空前	#NAME?
空想	#NAME?
空虚	#NAME?
恐怖	#NAME?
恐吓	#NAME?
恐慌	#NAME?
恐惧	#NAME?
恐龙	#NAME?
空白	#NAME?
空地	#NAME?
空隙	#NAME?
控告	#NAME?
抠	#NAME?
口碑	#NAME?
口才	#NAME?
口吃	#NAME?
口感	#NAME?
口径	#NAME?
口令	#NAME?
口气	#NAME?
口腔	#NAME?
口哨	#NAME?
口水	#NAME?
口头	#NAME?
口味	#NAME?
口香糖	#NAME?
口音	#NAME?
口罩	#NAME?
口子	#NAME?
扣除	#NAME?
扣留	#NAME?
扣人心弦	#NAME?
扣押	#NAME?
枯燥	#NAME?
哭泣	#NAME?
哭笑不得	#NAME?
窟窿	#NAME?
苦力	#NAME?
苦练	#NAME?
苦难	#NAME?
苦恼	#NAME?
苦笑	#NAME?
苦心	#NAME?
酷似	#NAME?
夸	#NAME?
夸大	#NAME?
夸奖	#NAME?
夸夸其谈	#NAME?
夸耀	#NAME?
夸张	#NAME?
垮	#NAME?
挎	#NAME?
跨国	#NAME?
跨越	#NAME?
快捷	#NAME?
宽敞	#NAME?
宽泛	#NAME?
宽厚	#NAME?
宽容	#NAME?
宽恕	#NAME?
宽松	#NAME?
款式	#NAME?
款项	#NAME?
筐	#NAME?
狂欢	#NAME?
狂欢节	#NAME?
狂热	#NAME?
旷课	#NAME?
况且	#NAME?
矿藏	#NAME?
框	#NAME?
框架	#NAME?
亏本	#NAME?
亏损	#NAME?
昆虫	#NAME?
捆	#NAME?
困惑	#NAME?
困境	#NAME?
扩	#NAME?
扩建	#NAME?
扩散	#NAME?
扩张	#NAME?
括弧	#NAME?
阔绰	#NAME?
拉动	#NAME?
拉拢	#NAME?
拉锁	#NAME?
啦啦队	#NAME?
喇叭	#NAME?
腊月	#NAME?
蜡	#NAME?
蜡烛	#NAME?
辣椒	#NAME?
来宾	#NAME?
来电	#NAME?
来访	#NAME?
来回	#NAME?
来历	#NAME?
来临	#NAME?
来龙去脉	#NAME?
来年	#NAME?
来源于	#NAME?
拦	#NAME?
栏	#NAME?
栏杆	#NAME?
蓝图	#NAME?
揽	#NAME?
缆车	#NAME?
懒得	#NAME?
懒惰	#NAME?
滥用	#NAME?
狼	#NAME?
狼狈	#NAME?
朗诵	#NAME?
浪	#NAME?
捞	#NAME?
劳动力	#NAME?
劳累	#NAME?
劳务	#NAME?
牢固	#NAME?
牢记	#NAME?
牢牢	#NAME?
唠叨	#NAME?
老伴儿	#NAME?
老大	#NAME?
老汉	#NAME?
老化	#NAME?
老人家	#NAME?
老实说	#NAME?
老远	#NAME?
老字号	#NAME?
姥姥	#NAME?
姥爷	#NAME?
涝	#NAME?
乐意	#NAME?
乐园	#NAME?
勒	#NAME?
雷同	#NAME?
累积	#NAME?
累计	#NAME?
类别	#NAME?
棱角	#NAME?
冷淡	#NAME?
冷冻	#NAME?
冷酷	#NAME?
冷酷无情	#NAME?
冷落	#NAME?
冷门	#NAME?
冷漠	#NAME?
冷笑	#NAME?
冷战	#NAME?
愣	#NAME?
离谱儿	#NAME?
离奇	#NAME?
离职	#NAME?
黎明	#NAME?
礼服	#NAME?
礼品	#NAME?
礼仪	#NAME?
里程碑	#NAME?
理睬	#NAME?
理会	#NAME?
理科	#NAME?
理念	#NAME?
理事	#NAME?
理所当然	#NAME?
理性	#NAME?
理直气壮	#NAME?
力不从心	#NAME?
力度	#NAME?
力求	#NAME?
力所能及	#NAME?
力争	#NAME?
历程	#NAME?
历届	#NAME?
历经	#NAME?
历来	#NAME?
历时	#NAME?
立方	#NAME?
立方米	#NAME?
立功	#NAME?
立交桥	#NAME?
立体	#NAME?
立足	#NAME?
励志	#NAME?
利害	#NAME?
利率	#NAME?
利索	#NAME?
粒	#NAME?
连滚带爬	#NAME?
连绵	#NAME?
连任	#NAME?
连锁	#NAME?
连锁店	#NAME?
连夜	#NAME?
怜惜	#NAME?
帘子	#NAME?
莲子	#NAME?
联邦	#NAME?
联欢	#NAME?
联网	#NAME?
廉价	#NAME?
廉洁	#NAME?
廉正	#NAME?
廉政	#NAME?
脸颊	#NAME?
炼	#NAME?
恋恋不舍	#NAME?
良	#NAME?
良心	#NAME?
良性	#NAME?
凉爽	#NAME?
两口子	#NAME?
两栖	#NAME?
亮点	#NAME?
亮丽	#NAME?
亮相	#NAME?
谅解	#NAME?
辽阔	#NAME?
疗法	#NAME?
疗效	#NAME?
寥寥无几	#NAME?
潦草	#NAME?
了结	#NAME?
了却	#NAME?
料到	#NAME?
料理	#NAME?
咧嘴	#NAME?
列举	#NAME?
劣势	#NAME?
劣质	#NAME?
烈士	#NAME?
猎犬	#NAME?
猎人	#NAME?
裂缝	#NAME?
裂痕	#NAME?
拎	#NAME?
邻国	#NAME?
临	#NAME?
临床	#NAME?
临街	#NAME?
临近	#NAME?
淋	#NAME?
灵	#NAME?
灵感	#NAME?
灵魂	#NAME?
灵机一动	#NAME?
灵敏	#NAME?
灵巧	#NAME?
灵通	#NAME?
凌晨	#NAME?
零花钱	#NAME?
零件	#NAME?
零钱	#NAME?
零售	#NAME?
领队	#NAME?
领会	#NAME?
领军	#NAME?
领略	#NAME?
领事	#NAME?
领事馆	#NAME?
领土	#NAME?
领悟	#NAME?
领养	#NAME?
领域	#NAME?
溜	#NAME?
溜达	#NAME?
浏览	#NAME?
浏览器	#NAME?
留恋	#NAME?
留念	#NAME?
留神	#NAME?
留心	#NAME?
留意	#NAME?
流畅	#NAME?
流程	#NAME?
流浪	#NAME?
流泪	#NAME?
流量	#NAME?
流露	#NAME?
流氓	#NAME?
流入	#NAME?
流失	#NAME?
流水	#NAME?
流淌	#NAME?
流向	#NAME?
流血	#NAME?
流域	#NAME?
流转	#NAME?
柳树	#NAME?
遛	#NAME?
龙舟	#NAME?
聋	#NAME?
聋人	#NAME?
笼子	#NAME?
隆重	#NAME?
垄断	#NAME?
笼统	#NAME?
笼罩	#NAME?
搂	#NAME?
露面	#NAME?
芦花	#NAME?
炉灶	#NAME?
炉子	#NAME?
卤味	#NAME?
鲁莽	#NAME?
录制	#NAME?
鹿	#NAME?
路程	#NAME?
路灯	#NAME?
路段	#NAME?
路况	#NAME?
路面	#NAME?
路人	#NAME?
路途	#NAME?
路子	#NAME?
露天	#NAME?
旅程	#NAME?
旅途	#NAME?
铝	#NAME?
屡	#NAME?
屡次	#NAME?
缕	#NAME?
履行	#NAME?
率	#NAME?
绿灯	#NAME?
绿地	#NAME?
孪生	#NAME?
卵	#NAME?
乱七八糟	#NAME?
掠夺	#NAME?
略	#NAME?
略微	#NAME?
抡	#NAME?
伦理	#NAME?
轮换	#NAME?
轮廓	#NAME?
轮流	#NAME?
轮胎	#NAME?
论述	#NAME?
论坛	#NAME?
论证	#NAME?
罗	#NAME?
萝卜	#NAME?
螺丝	#NAME?
裸	#NAME?
裸露	#NAME?
络绎不绝	#NAME?
落差	#NAME?
落地	#NAME?
落户	#NAME?
落下	#NAME?
麻	#NAME?
麻	#NAME?
麻痹	#NAME?
麻将	#NAME?
麻辣	#NAME?
麻木	#NAME?
麻醉	#NAME?
马后炮	#NAME?
马虎	#NAME?
马力	#NAME?
马桶	#NAME?
马戏	#NAME?
码	#NAME?
码	#NAME?
埋藏	#NAME?
埋伏	#NAME?
埋没	#NAME?
买不起	#NAME?
迈	#NAME?
迈进	#NAME?
卖弄	#NAME?
脉搏	#NAME?
脉络	#NAME?
埋怨	#NAME?
蛮	#NAME?
瞒	#NAME?
满怀	#NAME?
蔓延	#NAME?
漫	#NAME?
漫游	#NAME?
慢慢来	#NAME?
慢性	#NAME?
忙活	#NAME?
忙碌	#NAME?
忙乱	#NAME?
盲目	#NAME?
茫然	#NAME?
矛头	#NAME?
茅台	#NAME?
茂密	#NAME?
茂盛	#NAME?
冒充	#NAME?
冒犯	#NAME?
冒昧	#NAME?
冒险	#NAME?
没劲	#NAME?
没说的	#NAME?
没完没了	#NAME?
没意思	#NAME?
没辙	#NAME?
没准儿	#NAME?
玫瑰	#NAME?
枚	#NAME?
眉开眼笑	#NAME?
眉毛	#NAME?
煤矿	#NAME?
煤炭	#NAME?
每当	#NAME?
每逢	#NAME?
美德	#NAME?
美观	#NAME?
美化	#NAME?
美景	#NAME?
美满	#NAME?
美妙	#NAME?
美人	#NAME?
美味	#NAME?
美中不足	#NAME?
美滋滋	#NAME?
魅力	#NAME?
闷	#NAME?
门当户对	#NAME?
门槛	#NAME?
门铃	#NAME?
门路	#NAME?
闷	#NAME?
萌发	#NAME?
萌芽	#NAME?
盟友	#NAME?
朦胧	#NAME?
猛烈	#NAME?
猛然	#NAME?
梦幻	#NAME?
弥补	#NAME?
弥漫	#NAME?
迷惑	#NAME?
迷惑不解	#NAME?
迷恋	#NAME?
迷路	#NAME?
迷失	#NAME?
谜	#NAME?
谜底	#NAME?
谜团	#NAME?
谜语	#NAME?
秘方	#NAME?
秘诀	#NAME?
密不可分	#NAME?
密度	#NAME?
密封	#NAME?
密集	#NAME?
蜜	#NAME?
蜜蜂	#NAME?
蜜月	#NAME?
棉花	#NAME?
免	#NAME?
免不了	#NAME?
免除	#NAME?
免疫	#NAME?
免职	#NAME?
勉强	#NAME?
缅怀	#NAME?
面部	#NAME?
面粉	#NAME?
面红耳赤	#NAME?
面面俱到	#NAME?
面目全非	#NAME?
苗	#NAME?
苗条	#NAME?
苗头	#NAME?
描绘	#NAME?
瞄准	#NAME?
渺小	#NAME?
庙	#NAME?
庙会	#NAME?
灭绝	#NAME?
灭亡	#NAME?
民办	#NAME?
民俗	#NAME?
民用	#NAME?
民众	#NAME?
敏捷	#NAME?
敏锐	#NAME?
名副其实	#NAME?
名贵	#NAME?
名利	#NAME?
名气	#NAME?
名声	#NAME?
名言	#NAME?
名著	#NAME?
明朗	#NAME?
明媚	#NAME?
明智	#NAME?
铭记	#NAME?
命	#NAME?
命名	#NAME?
命题	#NAME?
摸索	#NAME?
模拟	#NAME?
磨合	#NAME?
磨难	#NAME?
磨损	#NAME?
蘑菇	#NAME?
魔鬼	#NAME?
魔术	#NAME?
抹	#NAME?
末日	#NAME?
没落	#NAME?
陌生	#NAME?
莫非	#NAME?
莫过于	#NAME?
莫名其妙	#NAME?
漠然	#NAME?
墨	#NAME?
默读	#NAME?
默默无闻	#NAME?
默契	#NAME?
谋害	#NAME?
谋求	#NAME?
谋生	#NAME?
牡丹	#NAME?
亩	#NAME?
木板	#NAME?
木材	#NAME?
木匠	#NAME?
木偶	#NAME?
目不转睛	#NAME?
目瞪口呆	#NAME?
目的地	#NAME?
目睹	#NAME?
目录	#NAME?
目中无人	#NAME?
沐浴露	#NAME?
牧场	#NAME?
牧民	#NAME?
募捐	#NAME?
墓碑	#NAME?
墓地	#NAME?
幕	#NAME?
幕后	#NAME?
穆斯林	#NAME?
拿手	#NAME?
哪知道	#NAME?
呐喊	#NAME?
纳闷儿	#NAME?
纳入	#NAME?
纳税	#NAME?
纳税人	#NAME?
乃	#NAME?
乃至	#NAME?
耐	#NAME?
耐人寻味	#NAME?
耐性	#NAME?
南瓜	#NAME?
难处	#NAME?
难得一见	#NAME?
难点	#NAME?
难怪	#NAME?
难关	#NAME?
难堪	#NAME?
难说	#NAME?
难为情	#NAME?
难以想象	#NAME?
难以置信	#NAME?
挠	#NAME?
恼羞成怒	#NAME?
脑海	#NAME?
脑筋	#NAME?
闹事	#NAME?
闹着玩儿	#NAME?
内存	#NAME?
内阁	#NAME?
内涵	#NAME?
内行	#NAME?
内幕	#NAME?
内向	#NAME?
内需	#NAME?
嫩	#NAME?
能耗	#NAME?
能耐	#NAME?
能人	#NAME?
能源	#NAME?
尼龙	#NAME?
泥潭	#NAME?
泥土	#NAME?
拟	#NAME?
拟定	#NAME?
逆	#NAME?
匿名	#NAME?
年画	#NAME?
年迈	#NAME?
年限	#NAME?
年薪	#NAME?
年夜饭	#NAME?
年终	#NAME?
黏	#NAME?
念念不忘	#NAME?
念书	#NAME?
念头	#NAME?
娘	#NAME?
酿造	#NAME?
鸟巢	#NAME?
尿	#NAME?
捏	#NAME?
拧	#NAME?
凝固	#NAME?
凝聚	#NAME?
拧	#NAME?
宁可	#NAME?
宁愿	#NAME?
扭曲	#NAME?
扭头	#NAME?
扭转	#NAME?
纽带	#NAME?
纽扣	#NAME?
农场	#NAME?
农历	#NAME?
农民工	#NAME?
农作物	#NAME?
浓厚	#NAME?
浓缩	#NAME?
浓郁	#NAME?
浓重	#NAME?
弄虚作假	#NAME?
奴隶	#NAME?
女婿	#NAME?
暖烘烘	#NAME?
虐待	#NAME?
挪	#NAME?
诺言	#NAME?
哦	#NAME?
殴打	#NAME?
呕吐	#NAME?
趴	#NAME?
拍板	#NAME?
拍卖	#NAME?
拍戏	#NAME?
排斥	#NAME?
排放	#NAME?
排练	#NAME?
徘徊	#NAME?
牌照	#NAME?
派别	#NAME?
派遣	#NAME?
鑾	#NAME?
攀升	#NAME?
盘	#NAME?
盘算	#NAME?
判处	#NAME?
判定	#NAME?
判决	#NAME?
盼	#NAME?
叛逆	#NAME?
庞大	#NAME?
旁观	#NAME?
抛	#NAME?
抛开	#NAME?
抛弃	#NAME?
刨	#NAME?
跑车	#NAME?
跑道	#NAME?
跑龙套	#NAME?
泡沫	#NAME?
胚胎	#NAME?
陪伴	#NAME?
陪葬	#NAME?
赔钱	#NAME?
佩服	#NAME?
配件	#NAME?
配偶	#NAME?
配送	#NAME?
配音	#NAME?
喷泉	#NAME?
抨击	#NAME?
烹调	#NAME?
蓬勃	#NAME?
鹏程万里	#NAME?
膨胀	#NAME?
捧	#NAME?
捧场	#NAME?
碰钉子	#NAME?
碰巧	#NAME?
碰上	#NAME?
碰撞	#NAME?
批发	#NAME?
批判	#NAME?
披露	#NAME?
劈	#NAME?
皮带	#NAME?
疲惫	#NAME?
疲惫不堪	#NAME?
疲倦	#NAME?
疲劳	#NAME?
脾	#NAME?
匹配	#NAME?
媲美	#NAME?
僻静	#NAME?
譬如	#NAME?
譬如说	#NAME?
片子	#NAME?
偏差	#NAME?
偏方	#NAME?
偏见	#NAME?
偏僻	#NAME?
偏偏	#NAME?
偏向	#NAME?
偏远	#NAME?
篇幅	#NAME?
片段	#NAME?
骗人	#NAME?
漂	#NAME?
飘	#NAME?
票房	#NAME?
撇	#NAME?
拼搏	#NAME?
拼命	#NAME?
贫富	#NAME?
贫穷	#NAME?
频率	#NAME?
频频	#NAME?
品尝	#NAME?
品德	#NAME?
品位	#NAME?
品行	#NAME?
聘	#NAME?
聘任	#NAME?
聘用	#NAME?
乒乓球	#NAME?
平常心	#NAME?
平淡	#NAME?
平和	#NAME?
平价	#NAME?
平面	#NAME?
平民	#NAME?
平日	#NAME?
平息	#NAME?
评定	#NAME?
评论员	#NAME?
评判	#NAME?
评审	#NAME?
评委	#NAME?
凭借	#NAME?
凭着	#NAME?
凭证	#NAME?
瓶颈	#NAME?
萍水相逢	#NAME?
泼冷水	#NAME?
颇	#NAME?
迫不及待	#NAME?
迫害	#NAME?
迫使	#NAME?
破案	#NAME?
破除	#NAME?
破解	#NAME?
破旧	#NAME?
破裂	#NAME?
破灭	#NAME?
破碎	#NAME?
魄力	#NAME?
扑克	#NAME?
扑面而来	#NAME?
铺路	#NAME?
菩萨	#NAME?
朴实	#NAME?
朴素	#NAME?
普通人	#NAME?
谱	#NAME?
瀑布	#NAME?
七嘴八舌	#NAME?
沏	#NAME?
凄凉	#NAME?
期盼	#NAME?
欺骗	#NAME?
欺诈	#NAME?
漆	#NAME?
齐心协力	#NAME?
其后	#NAME?
其间	#NAME?
奇花异草	#NAME?
奇迹	#NAME?
奇特	#NAME?
歧视	#NAME?
祈祷	#NAME?
棋	#NAME?
棋子	#NAME?
旗袍	#NAME?
旗帜	#NAME?
乞丐	#NAME?
乞求	#NAME?
乞讨	#NAME?
岂有此理	#NAME?
启迪	#NAME?
启蒙	#NAME?
启示	#NAME?
起步	#NAME?
起草	#NAME?
起程	#NAME?
起初	#NAME?
起伏	#NAME?
起劲	#NAME?
起跑线	#NAME?
起源	#NAME?
气愤	#NAME?
气管	#NAME?
气馁	#NAME?
气派	#NAME?
气泡	#NAME?
气魄	#NAME?
气势	#NAME?
气味	#NAME?
气息	#NAME?
气质	#NAME?
迄今	#NAME?
迄今为止	#NAME?
契机	#NAME?
契约	#NAME?
器材	#NAME?
器械	#NAME?
掐	#NAME?
卡	#NAME?
卡子	#NAME?
洽谈	#NAME?
恰到好处	#NAME?
恰恰相反	#NAME?
恰巧	#NAME?
恰如其分	#NAME?
千变万化	#NAME?
千方百计	#NAME?
千家万户	#NAME?
千军万马	#NAME?
千钧一发	#NAME?
迁	#NAME?
迁就	#NAME?
迁移	#NAME?
牵扯	#NAME?
牵挂	#NAME?
牵涉	#NAME?
牵头	#NAME?
牵制	#NAME?
铅	#NAME?
谦逊	#NAME?
签	#NAME?
签署	#NAME?
前辈	#NAME?
前不久	#NAME?
前赴后继	#NAME?
前期	#NAME?
前任	#NAME?
前所未有	#NAME?
前台	#NAME?
前无古人	#NAME?
前夕	#NAME?
前线	#NAME?
前沿	#NAME?
前仰后合	#NAME?
前者	#NAME?
虔诚	#NAME?
钱财	#NAME?
钳子	#NAME?
潜能	#NAME?
潜水	#NAME?
潜艇	#NAME?
潜移默化	#NAME?
潜在	#NAME?
谴责	#NAME?
欠缺	#NAME?
欠条	#NAME?
歉意	#NAME?
呛	#NAME?
枪毙	#NAME?
腔	#NAME?
强加	#NAME?
强劲	#NAME?
强项	#NAME?
强行	#NAME?
强硬	#NAME?
强占	#NAME?
强制	#NAME?
抢夺	#NAME?
抢劫	#NAME?
抢眼	#NAME?
敲边鼓	#NAME?
敲诈	#NAME?
乔装	#NAME?
瞧不起	#NAME?
巧合	#NAME?
窍门	#NAME?
翘	#NAME?
撬	#NAME?
切除	#NAME?
切断	#NAME?
切割	#NAME?
且	#NAME?
且	#NAME?
切身	#NAME?
窃取	#NAME?
钦佩	#NAME?
侵害	#NAME?
侵略	#NAME?
侵权	#NAME?
侵占	#NAME?
亲和力	#NAME?
亲近	#NAME?
亲朋好友	#NAME?
亲戚	#NAME?
亲情	#NAME?
亲热	#NAME?
亲身	#NAME?
亲生	#NAME?
亲手	#NAME?
亲友	#NAME?
勤工俭学	#NAME?
勤快	#NAME?
勤劳	#NAME?
寝室	#NAME?
青春期	#NAME?
青蛙	#NAME?
轻而易举	#NAME?
轻蔑	#NAME?
轻微	#NAME?
轻型	#NAME?
倾家荡产	#NAME?
倾诉	#NAME?
倾听	#NAME?
倾销	#NAME?
倾斜	#NAME?
清除	#NAME?
清脆	#NAME?
清单	#NAME?
清淡	#NAME?
清静	#NAME?
清凉	#NAME?
清明	#NAME?
清晰	#NAME?
清新	#NAME?
清真寺	#NAME?
情	#NAME?
情报	#NAME?
情不自禁	#NAME?
情调	#NAME?
情怀	#NAME?
情结	#NAME?
情侣	#NAME?
情人	#NAME?
情谊	#NAME?
情愿	#NAME?
请柬	#NAME?
请帖	#NAME?
庆典	#NAME?
庆贺	#NAME?
庆幸	#NAME?
丘陵	#NAME?
囚犯	#NAME?
求婚	#NAME?
求救	#NAME?
求学	#NAME?
求医	#NAME?
求证	#NAME?
求助	#NAME?
曲线	#NAME?
曲折	#NAME?
驱动	#NAME?
驱逐	#NAME?
屈服	#NAME?
趋于	#NAME?
曲	#NAME?
取代	#NAME?
取缔	#NAME?
取而代之	#NAME?
取经	#NAME?
取决于	#NAME?
取暖	#NAME?
取胜	#NAME?
取笑	#NAME?
娶	#NAME?
去除	#NAME?
去处	#NAME?
去向	#NAME?
趣味	#NAME?
圈套	#NAME?
圈子	#NAME?
权衡	#NAME?
权威	#NAME?
权益	#NAME?
全长	#NAME?
全程	#NAME?
全方位	#NAME?
全局	#NAME?
全力以赴	#NAME?
全能	#NAME?
全文	#NAME?
全心全意	#NAME?
拳	#NAME?
拳头	#NAME?
劝告	#NAME?
劝说	#NAME?
劝阻	#NAME?
缺口	#NAME?
缺失	#NAME?
缺席	#NAME?
确切	#NAME?
确信	#NAME?
确凿	#NAME?
确诊	#NAME?
燃放	#NAME?
燃气	#NAME?
燃油	#NAME?
嚷	#NAME?
让步	#NAME?
饶	#NAME?
饶恕	#NAME?
扰乱	#NAME?
绕行	#NAME?
惹	#NAME?
热潮	#NAME?
热带	#NAME?
热气	#NAME?
热气球	#NAME?
热腾腾	#NAME?
热衷	#NAME?
人次	#NAME?
人道	#NAME?
人格	#NAME?
人工智能	#NAME?
人均	#NAME?
人品	#NAME?
人气	#NAME?
人情	#NAME?
人身	#NAME?
人事	#NAME?
人手	#NAME?
人体	#NAME?
人为	#NAME?
人文	#NAME?
人行道	#NAME?
人性	#NAME?
人选	#NAME?
人缘儿	#NAME?
人造	#NAME?
人质	#NAME?
仁慈	#NAME?
忍饥挨饿	#NAME?
忍耐	#NAME?
忍心	#NAME?
认错	#NAME?
认证	#NAME?
认知	#NAME?
任命	#NAME?
任期	#NAME?
任人宰割	#NAME?
任意	#NAME?
任职	#NAME?
韧性	#NAME?
日程	#NAME?
日复一日	#NAME?
日后	#NAME?
日前	#NAME?
日趋	#NAME?
日新月异	#NAME?
日益	#NAME?
荣获	#NAME?
荣幸	#NAME?
荣誉	#NAME?
容光焕发	#NAME?
容量	#NAME?
容纳	#NAME?
容忍	#NAME?
容许	#NAME?
容颜	#NAME?
溶解	#NAME?
融	#NAME?
融化	#NAME?
融洽	#NAME?
冗长	#NAME?
柔和	#NAME?
柔软	#NAME?
揉	#NAME?
如果说	#NAME?
如实	#NAME?
如意	#NAME?
如愿以偿	#NAME?
如醉如痴	#NAME?
儒家	#NAME?
儒学	#NAME?
入场	#NAME?
入场券	#NAME?
入境	#NAME?
入侵	#NAME?
人手	#NAME?
入选	#NAME?
软弱	#NAME?
软实力	#NAME?
瑞雪	#NAME?
润	#NAME?
若干	#NAME?
弱点	#NAME?
弱势	#NAME?
撒	#NAME?
撒谎	#NAME?
赛车	#NAME?
赛跑	#NAME?
三番五次	#NAME?
三角	#NAME?
三维	#NAME?
散布	#NAME?
散发	#NAME?
桑拿	#NAME?
嗓子	#NAME?
丧生	#NAME?
骚乱	#NAME?
骚扰	#NAME?
扫除	#NAME?
扫描	#NAME?
扫墓	#NAME?
扫兴	#NAME?
嫂子	#NAME?
僧人	#NAME?
杀害	#NAME?
杀手	#NAME?
沙龙	#NAME?
沙滩	#NAME?
纱	#NAME?
刹车	#NAME?
砂糖	#NAME?
鲨鱼	#NAME?
傻瓜	#NAME?
筛	#NAME?
筛选	#NAME?
晒太阳	#NAME?
山川	#NAME?
山顶	#NAME?
山冈	#NAME?
山岭	#NAME?
山路	#NAME?
山寨	#NAME?
删	#NAME?
删除	#NAME?
煽动	#NAME?
闪烁	#NAME?
善	#NAME?
善意	#NAME?
擅长	#NAME?
擅自	#NAME?
膳食	#NAME?
赡养	#NAME?
伤残	#NAME?
伤感	#NAME?
伤痕	#NAME?
伤脑筋	#NAME?
伤势	#NAME?
商贩	#NAME?
商贾	#NAME?
商讨	#NAME?
上报	#NAME?
上场	#NAME?
上方	#NAME?
上岗	#NAME?
上火	#NAME?
上空	#NAME?
上流	#NAME?
上期	#NAME?
上任	#NAME?
上述	#NAME?
上司	#NAME?
上诉	#NAME?
上调	#NAME?
上头	#NAME?
上限	#NAME?
上旬	#NAME?
上瘾	#NAME?
上映	#NAME?
上游	#NAME?
尚	#NAME?
尚未	#NAME?
捎	#NAME?
烧毁	#NAME?
烧烤	#NAME?
稍后	#NAME?
稍候	#NAME?
稍稍	#NAME?
少不了	#NAME?
少见	#NAME?
少量	#NAME?
少有	#NAME?
少林寺	#NAME?
少女	#NAME?
奢侈	#NAME?
奢望	#NAME?
设	#NAME?
设定	#NAME?
设法	#NAME?
社会主义	#NAME?
社交	#NAME?
社论	#NAME?
社团	#NAME?
涉嫌	#NAME?
摄氏度	#NAME?
谁知道	#NAME?
申办	#NAME?
申报	#NAME?
申领	#NAME?
伸手	#NAME?
伸缩	#NAME?
伸张	#NAME?
身不由己	#NAME?
身价	#NAME?
身躯	#NAME?
身心	#NAME?
身影	#NAME?
身子	#NAME?
绅士	#NAME?
深奥	#NAME?
深切	#NAME?
深情	#NAME?
深入人心	#NAME?
深受	#NAME?
深思	#NAME?
深信	#NAME?
深夜	#NAME?
深远	#NAME?
神气	#NAME?
神圣	#NAME?
神态	#NAME?
神仙	#NAME?
宙	#NAME?
审定	#NAME?
审核	#NAME?
审美	#NAME?
审判	#NAME?
审批	#NAME?
审视	#NAME?
肾	#NAME?
甚至于	#NAME?
渗	#NAME?
渗透	#NAME?
慎重	#NAME?
升温	#NAME?
生机	#NAME?
生理	#NAME?
生命线	#NAME?
生怕	#NAME?
生平	#NAME?
生前	#NAME?
生死	#NAME?
生态	#NAME?
生物	#NAME?
生效	#NAME?
生涯	#NAME?
生硬	#NAME?
生育	#NAME?
声称	#NAME?
声望	#NAME?
声誉	#NAME?
牲畜	#NAME?
绳子	#NAME?
省略	#NAME?
省事	#NAME?
圣贤	#NAME?
胜出	#NAME?
胜任	#NAME?
盛大	#NAME?
盛会	#NAME?
盛开	#NAME?
盛气凌人	#NAME?
剩余	#NAME?
尸体	#NAME?
失传	#NAME?
失控	#NAME?
失利	#NAME?
失恋	#NAME?
失灵	#NAME?
失落	#NAME?
失眠	#NAME?
失明	#NAME?
失效	#NAME?
失业率	#NAME?
失踪	#NAME?
师范	#NAME?
师长	#NAME?
师资	#NAME?
狮子	#NAME?
施工	#NAME?
施加	#NAME?
施行	#NAME?
施压	#NAME?
湿度	#NAME?
湿润	#NAME?
十字路口	#NAME?
时不时	#NAME?
时段	#NAME?
时隔	#NAME?
时好时坏	#NAME?
时间表	#NAME?
时空	#NAME?
时髦	#NAME?
时尚	#NAME?
时速	#NAME?
识别	#NAME?
实地	#NAME?
实话	#NAME?
实话实说	#NAME?
实况	#NAME?
实事求是	#NAME?
实体	#NAME?
实物	#NAME?
实质	#NAME?
食宿	#NAME?
食用	#NAME?
史无前例	#NAME?
使唤	#NAME?
使命	#NAME?
使者	#NAME?
士气	#NAME?
示威	#NAME?
示意	#NAME?
世代	#NAME?
世故	#NAME?
世界级	#NAME?
世袭	#NAME?
市场经济	#NAME?
势必	#NAME?
势不可当	#NAME?
势头	#NAME?
事迹	#NAME?
事态	#NAME?
事务	#NAME?
事务所	#NAME?
事项	#NAME?
事宜	#NAME?
侍候	#NAME?
试探	#NAME?
试行	#NAME?
试用	#NAME?
试用期	#NAME?
视察	#NAME?
视角	#NAME?
视觉	#NAME?
视力	#NAME?
视线	#NAME?
视野	#NAME?
柿子	#NAME?
是非	#NAME?
适度	#NAME?
适量	#NAME?
适时	#NAME?
适宜	#NAME?
逝世	#NAME?
释放	#NAME?
嗜好	#NAME?
收复	#NAME?
收据	#NAME?
收敛	#NAME?
收留	#NAME?
收买	#NAME?
收视率	#NAME?
收缩	#NAME?
收支	#NAME?
手臂	#NAME?
手册	#NAME?
手动	#NAME?
手脚	#NAME?
手帕	#NAME?
手枪	#NAME?
手势	#NAME?
手术室	#NAME?
手头	#NAME?
手腕	#NAME?
手艺	#NAME?
手掌	#NAME?
守候	#NAME?
守护	#NAME?
守株待兔	#NAME?
首创	#NAME?
首府	#NAME?
首批	#NAME?
首饰	#NAME?
首要	#NAME?
寿命	#NAME?
受过	#NAME?
受害	#NAME?
受害人	#NAME?
受贿	#NAME?
受惊	#NAME?
受苦	#NAME?
受理	#NAME?
受骗	#NAME?
受益	#NAME?
授权	#NAME?
授予	#NAME?
售价	#NAME?
售票	#NAME?
书橱	#NAME?
书籍	#NAME?
书记	#NAME?
书面	#NAME?
书写	#NAME?
抒情	#NAME?
枢纽	#NAME?
梳	#NAME?
梳理	#NAME?
梳子	#NAME?
舒畅	#NAME?
疏导	#NAME?
疏忽	#NAME?
疏散	#NAME?
疏通	#NAME?
输家	#NAME?
输送	#NAME?
输血	#NAME?
输液	#NAME?
赎	#NAME?
暑期	#NAME?
属性	#NAME?
曙光	#NAME?
束缚	#NAME?
树立	#NAME?
树木	#NAME?
树梢	#NAME?
树荫	#NAME?
树枝	#NAME?
竖	#NAME?
数额	#NAME?
数据库	#NAME?
刷新	#NAME?
耍	#NAME?
耍赖	#NAME?
衰减	#NAME?
衰竭	#NAME?
衰老	#NAME?
衰弱	#NAME?
衰退	#NAME?
摔跤	#NAME?
甩	#NAME?
率	#NAME?
拴	#NAME?
涮	#NAME?
双胞胎	#NAME?
双边	#NAME?
双重	#NAME?
双向	#NAME?
双赢	#NAME?
霜	#NAME?
爽快	#NAME?
水槽	#NAME?
水稻	#NAME?
水管	#NAME?
水壶	#NAME?
水货	#NAME?
水晶	#NAME?
水利	#NAME?
水灵灵	#NAME?
水龙头	#NAME?
水落石出	#NAME?
水面	#NAME?
水手	#NAME?
水温	#NAME?
水域	#NAME?
水源	#NAME?
水涨船高	#NAME?
水准	#NAME?
税收	#NAME?
税务	#NAME?
睡袋	#NAME?
顺便	#NAME?
顺差	#NAME?
顺畅	#NAME?
顺从	#NAME?
顺理成章	#NAME?
顺路	#NAME?
顺其自然	#NAME?
顺势	#NAME?
顺手	#NAME?
顺心	#NAME?
顺应	#NAME?
顺着	#NAME?
瞬间	#NAME?
说白了	#NAME?
说不上	#NAME?
说到底	#NAME?
说道	#NAME?
说干就干	#NAME?
说谎	#NAME?
说老实话	#NAME?
说起来	#NAME?
说情	#NAME?
说闲话	#NAME?
说真的	#NAME?
硕果	#NAME?
司法	#NAME?
司空见惯	#NAME?
司令	#NAME?
丝	#NAME?
丝绸	#NAME?
丝毫	#NAME?
私房钱	#NAME?
私家车	#NAME?
私立	#NAME?
私事	#NAME?
私下	#NAME?
私营	#NAME?
私有	#NAME?
私自	#NAME?
思路	#NAME?
思念	#NAME?
思前想后	#NAME?
思索	#NAME?
撕	#NAME?
死心	#NAME?
死心塌地	#NAME?
四合院	#NAME?
四季	#NAME?
四面八方	#NAME?
寺庙	#NAME?
似曾相识	#NAME?
似是而非	#NAME?
伺机	#NAME?
饲料	#NAME?
饲养	#NAME?
松绑	#NAME?
松弛	#NAME?
耸立	#NAME?
送别	#NAME?
搜查	#NAME?
搜集	#NAME?
搜救	#NAME?
搜寻	#NAME?
艘	#NAME?
苏醒	#NAME?
酥	#NAME?
俗	#NAME?
俗话	#NAME?
俗话说	#NAME?
俗语	#NAME?
诉苦	#NAME?
诉说	#NAME?
诉讼	#NAME?
素	#NAME?
素不相识	#NAME?
素材	#NAME?
素描	#NAME?
素食	#NAME?
素养	#NAME?
塑造	#NAME?
蒜	#NAME?
算计	#NAME?
算盘	#NAME?
算账	#NAME?
虽说	#NAME?
随处可见	#NAME?
随大溜	#NAME?
随机	#NAME?
随即	#NAME?
随身	#NAME?
随时随地	#NAME?
随心所欲	#NAME?
遂心	#NAME?
隧道	#NAME?
损	#NAME?
损坏	#NAME?
损人利己	#NAME?
损伤	#NAME?
缩	#NAME?
缩水	#NAME?
缩影	#NAME?
所属	#NAME?
所谓	#NAME?
所作所为	#NAME?
索赔	#NAME?
索取	#NAME?
索性	#NAME?
锁定	#NAME?
他人	#NAME?
塌	#NAME?
踏上	#NAME?
胎	#NAME?
胎儿	#NAME?
台球	#NAME?
太极	#NAME?
太极拳	#NAME?
太平	#NAME?
泰斗	#NAME?
贪	#NAME?
贪婪	#NAME?
贪玩儿	#NAME?
贪污	#NAME?
摊	#NAME?
瘫	#NAME?
瘫痪	#NAME?
坛	#NAME?
谈不上	#NAME?
谈到	#NAME?
谈论	#NAME?
谈起	#NAME?
弹性	#NAME?
痰	#NAME?
坦白	#NAME?
坦诚	#NAME?
坦克	#NAME?
坦然	#NAME?
坦率	#NAME?
毯子	#NAME?
炭	#NAME?
探	#NAME?
探测	#NAME?
探亲	#NAME?
探求	#NAME?
探望	#NAME?
探险	#NAME?
碳	#NAME?
汤圆	#NAME?
堂	#NAME?
糖果	#NAME?
糖尿病	#NAME?
倘若	#NAME?
淌	#NAME?
烫	#NAME?
掏钱	#NAME?
滔滔不绝	#NAME?
逃避	#NAME?
逃生	#NAME?
逃亡	#NAME?
陶瓷	#NAME?
陶冶	#NAME?
陶醉	#NAME?
淘	#NAME?
淘气	#NAME?
淘汰	#NAME?
讨	#NAME?
讨好	#NAME?
讨价还价	#NAME?
讨人喜欢	#NAME?
特产	#NAME?
特长	#NAME?
特例	#NAME?
特权	#NAME?
特邀	#NAME?
特制	#NAME?
特质	#NAME?
腾	#NAME?
藤椅	#NAME?
剔除	#NAME?
梯子	#NAME?
提拔	#NAME?
提炼	#NAME?
提名	#NAME?
提速	#NAME?
提心吊胆	#NAME?
提议	#NAME?
提早	#NAME?
体谅	#NAME?
体面	#NAME?
体能	#NAME?
体贴	#NAME?
体温	#NAME?
体系	#NAME?
体制	#NAME?
体质	#NAME?
剃	#NAME?
替换	#NAME?
替身	#NAME?
天长地久	#NAME?
天地	#NAME?
天鹅	#NAME?
天分	#NAME?
天赋	#NAME?
天经地义	#NAME?
天平	#NAME?
天桥	#NAME?
天生	#NAME?
天使	#NAME?
天线	#NAME?
天性	#NAME?
天主教	#NAME?
添加	#NAME?
甜美	#NAME?
甜蜜	#NAME?
甜头	#NAME?
填补	#NAME?
填充	#NAME?
填写	#NAME?
舔	#NAME?
挑剔	#NAME?
条款	#NAME?
条例	#NAME?
条约	#NAME?
调侃	#NAME?
调控	#NAME?
调料	#NAME?
调试	#NAME?
挑起	#NAME?
挑衅	#NAME?
跳槽	#NAME?
跳动	#NAME?
跳伞	#NAME?
跳跃	#NAME?
贴近	#NAME?
贴切	#NAME?
帖子	#NAME?
听从	#NAME?
听话	#NAME?
停泊	#NAME?
停车位	#NAME?
停电	#NAME?
停顿	#NAME?
停放	#NAME?
停业	#NAME?
通畅	#NAME?
通车	#NAME?
通风	#NAME?
通告	#NAME?
通缉	#NAME?
通顺	#NAME?
通俗	#NAME?
通通	#NAME?
通往	#NAME?
通宵	#NAME?
通行证	#NAME?
同伴	#NAME?
同步	#NAME?
同等	#NAME?
同感	#NAME?
同伙	#NAME?
同类	#NAME?
同盟	#NAME?
同年	#NAME?
同人	#NAME?
同志	#NAME?
同舟共济	#NAME?
铜	#NAME?
统筹	#NAME?
统统	#NAME?
统治	#NAME?
捅	#NAME?
桶	#NAME?
筒	#NAME?
痛	#NAME?
痛心	#NAME?
偷看	#NAME?
偷窥	#NAME?
偷懒	#NAME?
头部	#NAME?
头顶	#NAME?
头号	#NAME?
头条	#NAME?
头头是道	#NAME?
头衔	#NAME?
头晕	#NAME?
投奔	#NAME?
投稿	#NAME?
投机	#NAME?
投射	#NAME?
投身	#NAME?
投降	#NAME?
透彻	#NAME?
透过	#NAME?
透气	#NAME?
透支	#NAME?
凸	#NAME?
凸显	#NAME?
秃	#NAME?
突发	#NAME?
突击	#NAME?
突破口	#NAME?
突如其来	#NAME?
图表	#NAME?
图像	#NAME?
图形	#NAME?
图纸	#NAME?
徒步	#NAME?
涂	#NAME?
屠杀	#NAME?
土匪	#NAME?
土壤	#NAME?
土生土长	#NAME?
团伙	#NAME?
团聚	#NAME?
团员	#NAME?
团圆	#NAME?
推测	#NAME?
推辞	#NAME?
推断	#NAME?
推翻	#NAME?
推荐	#NAME?
推理	#NAME?
推敲	#NAME?
推算	#NAME?
推卸	#NAME?
推选	#NAME?
推移	#NAME?
颓废	#NAME?
退回	#NAME?
退却	#NAME?
退让	#NAME?
退缩	#NAME?
退休金	#NAME?
退学	#NAME?
退役	#NAME?
屯	#NAME?
托付	#NAME?
拖累	#NAME?
拖欠	#NAME?
拖延	#NAME?
脱节	#NAME?
脱口而出	#NAME?
脱落	#NAME?
脱身	#NAME?
脱颖而出	#NAME?
驮	#NAME?
妥	#NAME?
妥当	#NAME?
妥善	#NAME?
妥协	#NAME?
拓宽	#NAME?
拓展	#NAME?
唾液	#NAME?
挖掘	#NAME?
挖苦	#NAME?
瓦	#NAME?
歪	#NAME?
歪曲	#NAME?
外表	#NAME?
外公	#NAME?
外行	#NAME?
外号	#NAME?
外籍	#NAME?
外贸	#NAME?
外貌	#NAME?
外婆	#NAME?
外企	#NAME?
外星人	#NAME?
外形	#NAME?
外援	#NAME?
丸	#NAME?
完备	#NAME?
完毕	#NAME?
完蛋	#NAME?
完好	#NAME?
玩耍	#NAME?
玩意儿	#NAME?
顽固	#NAME?
挽	#NAME?
挽回	#NAME?
挽救	#NAME?
晚间	#NAME?
晚年	#NAME?
晚期	#NAME?
惋惜	#NAME?
万分	#NAME?
万古长青	#NAME?
万能	#NAME?
万万	#NAME?
万无一失	#NAME?
汪洋	#NAME?
亡羊补牢	#NAME?
王国	#NAME?
王牌	#NAME?
网点	#NAME?
网民	#NAME?
往常	#NAME?
往返	#NAME?
往日	#NAME?
往事	#NAME?
妄想	#NAME?
忘不了	#NAME?
忘掉	#NAME?
旺	#NAME?
旺季	#NAME?
旺盛	#NAME?
望	#NAME?
望远镜	#NAME?
危及	#NAME?
危急	#NAME?
威风	#NAME?
威力	#NAME?
威慑	#NAME?
威信	#NAME?
微不足道	#NAME?
微观	#NAME?
微妙	#NAME?
微弱	#NAME?
微型	#NAME?
为人	#NAME?
违背	#NAME?
违约	#NAME?
违章	#NAME?
围墙	#NAME?
唯	#NAME?
唯独	#NAME?
伪造	#NAME?
伪装	#NAME?
尾气	#NAME?
尾声	#NAME?
纬度	#NAME?
委屈	#NAME?
委婉	#NAME?
委员	#NAME?
委员会	#NAME?
萎缩	#NAME?
卫视	#NAME?
未	#NAME?
未成年人	#NAME?
未经	#NAME?
未免	#NAME?
未知数	#NAME?
位子	#NAME?
味精	#NAME?
畏惧	#NAME?
畏缩	#NAME?
胃口	#NAME?
喂养	#NAME?
慰劳	#NAME?
温度计	#NAME?
温泉	#NAME?
温柔	#NAME?
温室	#NAME?
温习	#NAME?
温馨	#NAME?
瘟疫	#NAME?
文	#NAME?
文具	#NAME?
文科	#NAME?
文盲	#NAME?
文凭	#NAME?
文人	#NAME?
文物	#NAME?
文献	#NAME?
文雅	#NAME?
闻名	#NAME?
蚊帐	#NAME?
蚊子	#NAME?
吻	#NAME?
吻合	#NAME?
紊乱	#NAME?
稳固	#NAME?
稳健	#NAME?
稳妥	#NAME?
稳重	#NAME?
问卷	#NAME?
问世	#NAME?
窝	#NAME?
卧	#NAME?
污秽	#NAME?
巫婆	#NAME?
呜咽	#NAME?
屋顶	#NAME?
无比	#NAME?
无不	#NAME?
无偿	#NAME?
无敌	#NAME?
无恶不作	#NAME?
无非	#NAME?
无辜	#NAME?
无故	#NAME?
无关紧要	#NAME?
无话可说	#NAME?
无济于事	#NAME?
无家可归	#NAME?
无精打采	#NAME?
无可奉告	#NAME?
无可厚非	#NAME?
无可奈何	#NAME?
无理	#NAME?
无力	#NAME?
无论如何	#NAME?
无能	#NAME?
无能为力	#NAME?
无情	#NAME?
无情无义	#NAME?
无穷	#NAME?
无私	#NAME?
无所事事	#NAME?
无所作为	#NAME?
无条件	#NAME?
无微不至	#NAME?
无线	#NAME?
无线电	#NAME?
无形	#NAME?
无形中	#NAME?
无须	#NAME?
无意	#NAME?
无忧无虑	#NAME?
无缘	#NAME?
无知	#NAME?
无足轻重	#NAME?
五花八门	#NAME?
五星级	#NAME?
武力	#NAME?
武装	#NAME?
侮辱	#NAME?
捂	#NAME?
舞厅	#NAME?
勿	#NAME?
务必	#NAME?
务实	#NAME?
物流	#NAME?
物体	#NAME?
物证	#NAME?
物资	#NAME?
误差	#NAME?
误导	#NAME?
误区	#NAME?
雾	#NAME?
吸纳	#NAME?
吸取	#NAME?
昔日	#NAME?
息息相关	#NAME?
稀	#NAME?
稀罕	#NAME?
稀奇	#NAME?
稀少	#NAME?
锡	#NAME?
熙熙攘攘	#NAME?
熄火	#NAME?
膝盖	#NAME?
嬉笑	#NAME?
习俗	#NAME?
席	#NAME?
席位	#NAME?
袭击	#NAME?
媳妇	#NAME?
洗涤剂	#NAME?
洗礼	#NAME?
喜出望外	#NAME?
喜好	#NAME?
喜酒	#NAME?
喜怒哀乐	#NAME?
喜庆	#NAME?
喜事	#NAME?
喜糖	#NAME?
喜洋洋	#NAME?
喜悦	#NAME?
细腻	#NAME?
细微	#NAME?
细心	#NAME?
虾	#NAME?
瞎	#NAME?
侠义	#NAME?
峡谷	#NAME?
狭隘	#NAME?
狭小	#NAME?
狭窄	#NAME?
下场	#NAME?
下跌	#NAME?
下岗	#NAME?
下功夫	#NAME?
下海	#NAME?
下级	#NAME?
下决心	#NAME?
下令	#NAME?
下落	#NAME?
下期	#NAME?
下棋	#NAME?
下山	#NAME?
下手	#NAME?
下属	#NAME?
下台	#NAME?
下调	#NAME?
下乡	#NAME?
下旬	#NAME?
下一代	#NAME?
下意识	#NAME?
下游	#NAME?
下坠	#NAME?
吓唬	#NAME?
吓人	#NAME?
夏令营	#NAME?
仙鹤	#NAME?
仙女	#NAME?
先例	#NAME?
先天	#NAME?
纤维	#NAME?
掀	#NAME?
掀起	#NAME?
鲜活	#NAME?
鲜美	#NAME?
鲜血	#NAME?
弦	#NAME?
衔接	#NAME?
嫌弃	#NAME?
嫌疑	#NAME?
显而易见	#NAME?
显赫	#NAME?
显示器	#NAME?
显现	#NAME?
显眼	#NAME?
现成	#NAME?
现任	#NAME?
现行	#NAME?
限	#NAME?
限定	#NAME?
限度	#NAME?
限于	#NAME?
线条	#NAME?
宪法	#NAME?
陷	#NAME?
陷阱	#NAME?
馅儿	#NAME?
羡慕	#NAME?
献血	#NAME?
腺	#NAME?
乡亲	#NAME?
乡下	#NAME?
相伴	#NAME?
相比之下	#NAME?
相差	#NAME?
相传	#NAME?
相当于	#NAME?
相对	#NAME?
相对而言	#NAME?
相辅相成	#NAME?
相继	#NAME?
相连	#NAME?
相识	#NAME?
相提并论	#NAME?
相通	#NAME?
相依为命	#NAME?
相遇	#NAME?
相约	#NAME?
香料	#NAME?
香水	#NAME?
香味	#NAME?
香烟	#NAME?
香油	#NAME?
镶	#NAME?
镶嵌	#NAME?
详尽	#NAME?
祥和	#NAME?
享	#NAME?
享有	#NAME?
响亮	#NAME?
响起	#NAME?
响应	#NAME?
想方设法	#NAME?
向来	#NAME?
向往	#NAME?
向着	#NAME?
项链	#NAME?
像	#NAME?
像样	#NAME?
橡胶	#NAME?
橡皮	#NAME?
削	#NAME?
消	#NAME?
消沉	#NAME?
消遣	#NAME?
萧条	#NAME?
销	#NAME?
销毁	#NAME?
销量	#NAME?
潇洒	#NAME?
小丑	#NAME?
小贩	#NAME?
小看	#NAME?
小康	#NAME?
小路	#NAME?
小品	#NAME?
小气	#NAME?
小区	#NAME?
小曲	#NAME?
小人	#NAME?
小提琴	#NAME?
小溪	#NAME?
小心翼翼	#NAME?
小卒	#NAME?
孝敬	#NAME?
孝顺	#NAME?
肖像	#NAME?
效仿	#NAME?
效力	#NAME?
效益	#NAME?
效应	#NAME?
协定	#NAME?
协同	#NAME?
协作	#NAME?
邪	#NAME?
邪恶	#NAME?
挟持	#NAME?
携带	#NAME?
携手	#NAME?
写照	#NAME?
泄	#NAME?
泄漏	#NAME?
泄露	#NAME?
泄密	#NAME?
泄气	#NAME?
泻	#NAME?
卸	#NAME?
心爱	#NAME?
心安理得	#NAME?
心病	#NAME?
心肠	#NAME?
心得	#NAME?
心慌	#NAME?
心急如焚	#NAME?
心里话	#NAME?
心灵手巧	#NAME?
心目	#NAME?
心声	#NAME?
心事	#NAME?
心思	#NAME?
心酸	#NAME?
心想事成	#NAME?
心胸	#NAME?
心血	#NAME?
心眼儿	#NAME?
心意	#NAME?
芯片	#NAME?
辛勤	#NAME?
辛酸	#NAME?
欣慰	#NAME?
欣喜	#NAME?
欣欣向荣	#NAME?
新潮	#NAME?
新陈代谢	#NAME?
新房	#NAME?
新款	#NAME?
新奇	#NAME?
新生	#NAME?
新式	#NAME?
新手	#NAME?
新颖	#NAME?
信贷	#NAME?
信件	#NAME?
信赖	#NAME?
信誉	#NAME?
兴奋剂	#NAME?
兴建	#NAME?
兴起	#NAME?
星座	#NAME?
猩猩	#NAME?
腥	#NAME?
刑法	#NAME?
行使	#NAME?
行政	#NAME?
行走	#NAME?
形形色色	#NAME?
形影不离	#NAME?
醒来	#NAME?
醒目	#NAME?
醒悟	#NAME?
兴高采烈	#NAME?
兴致	#NAME?
幸存	#NAME?
幸好	#NAME?
幸亏	#NAME?
幸免	#NAME?
性价比	#NAME?
性命	#NAME?
性情	#NAME?
姓氏	#NAME?
凶残	#NAME?
凶恶	#NAME?
凶狠	#NAME?
凶猛	#NAME?
汹涌	#NAME?
胸膛	#NAME?
胸有成竹	#NAME?
雄厚	#NAME?
休克	#NAME?
休眠	#NAME?
休想	#NAME?
休养	#NAME?
修补	#NAME?
修长	#NAME?
修订	#NAME?
修路	#NAME?
修正	#NAME?
羞愧	#NAME?
秀丽	#NAME?
秀美	#NAME?
袖手旁观	#NAME?
绣	#NAME?
锈	#NAME?
嗅觉	#NAME?
须	#NAME?
虚	#NAME?
虚构	#NAME?
虚幻	#NAME?
虚假	#NAME?
虚拟	#NAME?
虚弱	#NAME?
虚伪	#NAME?
需	#NAME?
徐徐	#NAME?
许	#NAME?
许可证	#NAME?
旭日	#NAME?
序	#NAME?
序幕	#NAME?
叙述	#NAME?
酗酒	#NAME?
续	#NAME?
絮叨	#NAME?
宣称	#NAME?
宣读	#NAME?
宣告	#NAME?
宣誓	#NAME?
宣泄	#NAME?
宣言	#NAME?
宣扬	#NAME?
喧哗	#NAME?
喧闹	#NAME?
玄	#NAME?
玄机	#NAME?
悬挂	#NAME?
悬念	#NAME?
悬殊	#NAME?
悬崖	#NAME?
旋律	#NAME?
旋涡	#NAME?
选民	#NAME?
选项	#NAME?
选用	#NAME?
炫耀	#NAME?
削弱	#NAME?
靴子	#NAME?
穴位	#NAME?
学历	#NAME?
学士	#NAME?
学说	#NAME?
学堂	#NAME?
学业	#NAME?
学艺	#NAME?
学子	#NAME?
雪山	#NAME?
雪上加霜	#NAME?
血脉	#NAME?
血栓	#NAME?
血压	#NAME?
血缘	#NAME?
勋章	#NAME?
熏	#NAME?
熏陶	#NAME?
寻	#NAME?
寻常	#NAME?
寻觅	#NAME?
巡逻	#NAME?
循序渐进	#NAME?
训	#NAME?
驯	#NAME?
逊色	#NAME?
丫头	#NAME?
压倒	#NAME?
压缩	#NAME?
压抑	#NAME?
压制	#NAME?
押	#NAME?
鸦雀无声	#NAME?
牙齿	#NAME?
牙膏	#NAME?
芽	#NAME?
哑	#NAME?
咽喉	#NAME?
烟囱	#NAME?
烟火	#NAME?
淹	#NAME?
延	#NAME?
延缓	#NAME?
延误	#NAME?
严谨	#NAME?
严禁	#NAME?
严峻	#NAME?
严密	#NAME?
言辞	#NAME?
言论	#NAME?
言行	#NAME?
岩石	#NAME?
炎热	#NAME?
炎症	#NAME?
沿岸	#NAME?
沿途	#NAME?
沿线	#NAME?
研讨	#NAME?
阎王	#NAME?
衍生	#NAME?
掩盖	#NAME?
掩护	#NAME?
掩饰	#NAME?
眼红	#NAME?
眼界	#NAME?
眼色	#NAME?
眼神	#NAME?
眼下	#NAME?
演变	#NAME?
演播室	#NAME?
演技	#NAME?
演练	#NAME?
演示	#NAME?
演说	#NAME?
演习	#NAME?
演戏	#NAME?
演艺圈	#NAME?
演绎	#NAME?
厌烦	#NAME?
厌倦	#NAME?
咽	#NAME?
艳丽	#NAME?
验	#NAME?
验收	#NAME?
验证	#NAME?
焰火	#NAME?
燕子	#NAME?
秧歌	#NAME?
扬	#NAME?
阳性	#NAME?
杨树	#NAME?
洋溢	#NAME?
养活	#NAME?
养老金	#NAME?
养老院	#NAME?
养生	#NAME?
养殖	#NAME?
氧	#NAME?
痒	#NAME?
样本	#NAME?
样品	#NAME?
妖怪	#NAME?
邀	#NAME?
窑	#NAME?
谣言	#NAME?
摇摆	#NAME?
摇滚	#NAME?
摇晃	#NAME?
摇篮	#NAME?
摇摇欲坠	#NAME?
遥控	#NAME?
遥远	#NAME?
药材	#NAME?
药方	#NAME?
要不	#NAME?
要不是	#NAME?
要点	#NAME?
要害	#NAME?
要紧	#NAME?
要领	#NAME?
要命	#NAME?
要强	#NAME?
钥匙	#NAME?
耀眼	#NAME?
椰子	#NAME?
也就是说	#NAME?
野餐	#NAME?
野炊	#NAME?
野蛮	#NAME?
野兽	#NAME?
野外	#NAME?
野心	#NAME?
野营	#NAME?
业	#NAME?
业绩	#NAME?
夜班	#NAME?
夜市	#NAME?
夜晚	#NAME?
夜校	#NAME?
夜以继日	#NAME?
夜总会	#NAME?
液晶	#NAME?
液体	#NAME?
一把手	#NAME?
一线	#NAME?
一一	#NAME?
伊斯兰教	#NAME?
衣食住行	#NAME?
医务	#NAME?
依	#NAME?
依托	#NAME?
依依不舍	#NAME?
一不小心	#NAME?
一刹那	#NAME?
一大早	#NAME?
一动不动	#NAME?
一度	#NAME?
一概	#NAME?
一概而论	#NAME?
一个劲儿	#NAME?
一晃	#NAME?
一技之长	#NAME?
一面	#NAME?
一目了然	#NAME?
一事无成	#NAME?
一瞬间	#NAME?
一味	#NAME?
一系列	#NAME?
一阵	#NAME?
仪表	#NAME?
恰然自得	#NAME?
姨	#NAME?
移交	#NAME?
移植	#NAME?
遗留	#NAME?
遗弃	#NAME?
遗体	#NAME?
遗忘	#NAME?
遗物	#NAME?
遗愿	#NAME?
遗址	#NAME?
遗嘱	#NAME?
疑点	#NAME?
疑惑	#NAME?
疑虑	#NAME?
以	#NAME?
以免	#NAME?
以身作则	#NAME?
以至于	#NAME?
以致	#NAME?
矣	#NAME?
倚	#NAME?
一长一短	#NAME?
一成不变	#NAME?
一筹莫展	#NAME?
一帆风顺	#NAME?
一干二净	#NAME?
一鼓作气	#NAME?
一锅粥	#NAME?
一回事	#NAME?
一家人	#NAME?
一经	#NAME?
一举	#NAME?
一举一动	#NAME?
一卡通	#NAME?
一揽子	#NAME?
一连	#NAME?
一连串	#NAME?
一毛不拔	#NAME?
一年到头	#NAME?
一旁	#NAME?
一如既往	#NAME?
一声不吭	#NAME?
一手	#NAME?
一塌糊涂	#NAME?
一体	#NAME?
一天到晚	#NAME?
一头	#NAME?
一无所有	#NAME?
一无所知	#NAME?
一心	#NAME?
一心一意	#NAME?
一言不发	#NAME?
一言一行	#NAME?
一眼	#NAME?
一应俱全	#NAME?
一早	#NAME?
义工	#NAME?
议	#NAME?
议程	#NAME?
议会	#NAME?
议员	#NAME?
屹立	#NAME?
亦	#NAME?
异口同声	#NAME?
异想天开	#NAME?
异性	#NAME?
异议	#NAME?
抑扬顿挫	#NAME?
抑郁	#NAME?
抑郁症	#NAME?
抑制	#NAME?
译	#NAME?
易拉罐	#NAME?
疫苗	#NAME?
益处	#NAME?
意料	#NAME?
意料之外	#NAME?
意图	#NAME?
意向	#NAME?
溢	#NAME?
毅力	#NAME?
毅然	#NAME?
因人而异	#NAME?
阴暗	#NAME?
阴性	#NAME?
音响	#NAME?
殷勤	#NAME?
银幕	#NAME?
引发	#NAME?
引经据典	#NAME?
引领	#NAME?
引擎	#NAME?
引人人胜	#NAME?
引人注目	#NAME?
引入	#NAME?
引用	#NAME?
引诱	#NAME?
饮水	#NAME?
饮用水	#NAME?
隐蔽	#NAME?
隐患	#NAME?
隐瞒	#NAME?
隐情	#NAME?
隐身	#NAME?
隐形	#NAME?
隐性	#NAME?
隐约	#NAME?
瘾	#NAME?
印刷术	#NAME?
印章	#NAME?
印证	#NAME?
应有尽有	#NAME?
英镑	#NAME?
英俊	#NAME?
婴儿	#NAME?
鹰	#NAME?
迎	#NAME?
迎合	#NAME?
荧光	#NAME?
盈利	#NAME?
营救	#NAME?
营造	#NAME?
赢家	#NAME?
影像	#NAME?
应酬	#NAME?
应付	#NAME?
应聘	#NAME?
应邀	#NAME?
映	#NAME?
硬币	#NAME?
硬朗	#NAME?
硬盘	#NAME?
拥护	#NAME?
拥挤	#NAME?
庸俗	#NAME?
永不	#NAME?
永恒	#NAME?
永久	#NAME?
勇往直前	#NAME?
勇于	#NAME?
涌	#NAME?
涌入	#NAME?
涌现	#NAME?
踊跃	#NAME?
用餐	#NAME?
用功	#NAME?
用力	#NAME?
用人	#NAME?
用意	#NAME?
优	#NAME?
优化	#NAME?
优雅	#NAME?
优异	#NAME?
优越	#NAME?
忧愁	#NAME?
忧虑	#NAME?
忧郁	#NAME?
悠久	#NAME?
悠闲	#NAME?
尤为	#NAME?
由此看来	#NAME?
由此可见	#NAME?
由来	#NAME?
由衷	#NAME?
邮编	#NAME?
邮政	#NAME?
犹如	#NAME?
犹豫不决	#NAME?
油画	#NAME?
游船	#NAME?
游览	#NAME?
友情	#NAME?
友人	#NAME?
友善	#NAME?
有待	#NAME?
有的放矢	#NAME?
有机	#NAME?
有口无心	#NAME?
有两下子	#NAME?
有声有色	#NAME?
有所	#NAME?
有所不同	#NAME?
有望	#NAME?
有效期	#NAME?
有幸	#NAME?
有序	#NAME?
有益	#NAME?
有意	#NAME?
有朝一日	#NAME?
有助于	#NAME?
幼稚	#NAME?
诱饵	#NAME?
诱发	#NAME?
诱惑	#NAME?
诱人	#NAME?
余	#NAME?
余地	#NAME?
余额	#NAME?
渔船	#NAME?
渔民	#NAME?
逾期	#NAME?
愚蠢	#NAME?
愚公移山	#NAME?
舆论	#NAME?
与此同时	#NAME?
与否	#NAME?
与其	#NAME?
与日俱增	#NAME?
与时俱进	#NAME?
与众不同	#NAME?
予以	#NAME?
宇宙	#NAME?
语气	#NAME?
浴室	#NAME?
预定	#NAME?
预感	#NAME?
预告	#NAME?
预见	#NAME?
预料	#NAME?
预赛	#NAME?
预示	#NAME?
预售	#NAME?
预算	#NAME?
预先	#NAME?
预言	#NAME?
预兆	#NAME?
欲望	#NAME?
遇难	#NAME?
遇上	#NAME?
遇险	#NAME?
寓言	#NAME?
寓意	#NAME?
愈合	#NAME?
愈来愈	#NAME?
愈演愈烈	#NAME?
冤	#NAME?
冤枉	#NAME?
渊源	#NAME?
元老	#NAME?
元首	#NAME?
元宵节	#NAME?
原本	#NAME?
原材料	#NAME?
原创	#NAME?
原地	#NAME?
原型	#NAME?
原汁原味	#NAME?
原装	#NAME?
圆形	#NAME?
缘分	#NAME?
源泉	#NAME?
源头	#NAME?
源于	#NAME?
源源不断	#NAME?
远程	#NAME?
远见	#NAME?
远近闻名	#NAME?
怨恨	#NAME?
怨气	#NAME?
怨言	#NAME?
院士	#NAME?
曰	#NAME?
约定俗成	#NAME?
月初	#NAME?
月票	#NAME?
乐器	#NAME?
岳父	#NAME?
岳母	#NAME?
阅历	#NAME?
悦耳	#NAME?
越发	#NAME?
越过	#NAME?
晕倒	#NAME?
陨石	#NAME?
孕妇	#NAME?
孕育	#NAME?
运河	#NAME?
运送	#NAME?
运营	#NAME?
运转	#NAME?
酝酿	#NAME?
韵味	#NAME?
蕴藏	#NAME?
蕴涵	#NAME?
杂技	#NAME?
杂交	#NAME?
杂乱无章	#NAME?
砸	#NAME?
栽	#NAME?
栽培	#NAME?
宰	#NAME?
再度	#NAME?
再现	#NAME?
在线	#NAME?
在意	#NAME?
在职	#NAME?
载体	#NAME?
攒	#NAME?
暂	#NAME?
赞不绝口	#NAME?
赞美	#NAME?
赞叹	#NAME?
赞叹不已	#NAME?
赞同	#NAME?
赞许	#NAME?
赞扬	#NAME?
葬	#NAME?
葬礼	#NAME?
遭殃	#NAME?
凿	#NAME?
早年	#NAME?
早日	#NAME?
枣	#NAME?
造福	#NAME?
造假	#NAME?
造价	#NAME?
造就	#NAME?
造纸术	#NAME?
噪声	#NAME?
噪音	#NAME?
则	#NAME?
则	#NAME?
责备	#NAME?
责怪	#NAME?
贼	#NAME?
增收	#NAME?
增添	#NAME?
扎根	#NAME?
渣子	#NAME?
闸	#NAME?
炸	#NAME?
眨眼	#NAME?
诈骗	#NAME?
榨	#NAME?
窄	#NAME?
债务	#NAME?
占卜	#NAME?
沾	#NAME?
沾光	#NAME?
粘	#NAME?
瞻仰	#NAME?
斩	#NAME?
斩草除根	#NAME?
盏	#NAME?
展出	#NAME?
展览会	#NAME?
展望	#NAME?
崭新	#NAME?
占用	#NAME?
站立	#NAME?
绽放	#NAME?
蘸	#NAME?
张灯结彩	#NAME?
张贴	#NAME?
张扬	#NAME?
长辈	#NAME?
长相	#NAME?
掌管	#NAME?
帐篷	#NAME?
帐子	#NAME?
账单	#NAME?
账号	#NAME?
胀	#NAME?
招标	#NAME?
招待	#NAME?
招待会	#NAME?
招揽	#NAME?
招募	#NAME?
招牌	#NAME?
招收	#NAME?
招数	#NAME?
朝气蓬勃	#NAME?
朝三暮四	#NAME?
朝夕相处	#NAME?
着迷	#NAME?
沼泽	#NAME?
召集	#NAME?
兆头	#NAME?
照办	#NAME?
照常	#NAME?
照例	#NAME?
照料	#NAME?
照明	#NAME?
罩	#NAME?
肇事	#NAME?
折腾	#NAME?
遮	#NAME?
遮盖	#NAME?
折叠	#NAME?
折合	#NAME?
折扣	#NAME?
折磨	#NAME?
折射	#NAME?
这会儿	#NAME?
这样一来	#NAME?
针锋相对	#NAME?
针灸	#NAME?
侦察	#NAME?
珍藏	#NAME?
珍视	#NAME?
珍重	#NAME?
真假	#NAME?
真空	#NAME?
真情	#NAME?
真是的	#NAME?
真心	#NAME?
真挚	#NAME?
诊所	#NAME?
枕头	#NAME?
阵容	#NAME?
阵营	#NAME?
振奋	#NAME?
振兴	#NAME?
振作	#NAME?
震	#NAME?
震动	#NAME?
震撼	#NAME?
镇定	#NAME?
争吵	#NAME?
争端	#NAME?
争分夺秒	#NAME?
争光	#NAME?
争气	#NAME?
争先恐后	#NAME?
争执	#NAME?
征	#NAME?
征集	#NAME?
征收	#NAME?
挣扎	#NAME?
症结	#NAME?
睁	#NAME?
蒸	#NAME?
拯救	#NAME?
整合	#NAME?
整洁	#NAME?
整数	#NAME?
正面	#NAME?
正能量	#NAME?
正视	#NAME?
正直	#NAME?
正宗	#NAME?
证人	#NAME?
郑重	#NAME?
之	#NAME?
之	#NAME?
之所以	#NAME?
支票	#NAME?
支柱	#NAME?
汁	#NAME?
芝麻	#NAME?
芝士	#NAME?
知己	#NAME?
知觉	#NAME?
知识分子	#NAME?
知足	#NAME?
肢体	#NAME?
脂肪	#NAME?
执法	#NAME?
执意	#NAME?
执照	#NAME?
执着	#NAME?
直奔	#NAME?
直达	#NAME?
直观	#NAME?
直径	#NAME?
直觉	#NAME?
直视	#NAME?
直至	#NAME?
值钱	#NAME?
职权	#NAME?
职业病	#NAME?
职员	#NAME?
止步	#NAME?
止咳	#NAME?
止血	#NAME?
旨在	#NAME?
指点	#NAME?
指教	#NAME?
指令	#NAME?
指南	#NAME?
指南针	#NAME?
指手画脚	#NAME?
指望	#NAME?
指向	#NAME?
指引	#NAME?
至此	#NAME?
至关重要	#NAME?
志气	#NAME?
制	#NAME?
制裁	#NAME?
制服	#NAME?
制品	#NAME?
制止	#NAME?
质地	#NAME?
质朴	#NAME?
质问	#NAME?
质疑	#NAME?
治学	#NAME?
治愈	#NAME?
致	#NAME?
致辞	#NAME?
致富	#NAME?
致敬	#NAME?
致力于	#NAME?
致命	#NAME?
致使	#NAME?
秩序	#NAME?
窒息	#NAME?
智商	#NAME?
滞后	#NAME?
滞留	#NAME?
置	#NAME?
中国画	#NAME?
中立	#NAME?
中途	#NAME?
中型	#NAME?
中性	#NAME?
中旬	#NAME?
中庸	#NAME?
中止	#NAME?
忠诚	#NAME?
忠实	#NAME?
忠于	#NAME?
忠贞	#NAME?
终结	#NAME?
终究	#NAME?
终生	#NAME?
衷心	#NAME?
肿瘤	#NAME?
种族	#NAME?
仲裁	#NAME?
众人	#NAME?
众所周知	#NAME?
众志成城	#NAME?
重创	#NAME?
重量级	#NAME?
重任	#NAME?
重伤	#NAME?
重心	#NAME?
重型	#NAME?
重中之重	#NAME?
周边	#NAME?
周到	#NAME?
周密	#NAME?
周旋	#NAME?
昼夜	#NAME?
皱	#NAME?
骤然	#NAME?
朱红	#NAME?
株	#NAME?
诸多	#NAME?
诸如此类	#NAME?
竹竿	#NAME?
逐年	#NAME?
主	#NAME?
主编	#NAME?
主妇	#NAME?
主力	#NAME?
主权	#NAME?
主人公	#NAME?
主食	#NAME?
主题歌	#NAME?
主演	#NAME?
主页	#NAME?
主义	#NAME?
主宰	#NAME?
拄	#NAME?
嘱咐	#NAME?
瞩目	#NAME?
助威	#NAME?
住处	#NAME?
住户	#NAME?
住宿	#NAME?
住址	#NAME?
贮藏	#NAME?
注	#NAME?
注定	#NAME?
注入	#NAME?
铸造	#NAME?
筑	#NAME?
爪子	#NAME?
拽	#NAME?
专长	#NAME?
专程	#NAME?
专柜	#NAME?
专栏	#NAME?
专卖店	#NAME?
专人	#NAME?
专职	#NAME?
专制	#NAME?
专注	#NAME?
专著	#NAME?
砖	#NAME?
转播	#NAME?
转达	#NAME?
转机	#NAME?
转交	#NAME?
转型	#NAME?
转学	#NAME?
转眼	#NAME?
转载	#NAME?
转折	#NAME?
转折点	#NAME?
传	#NAME?
传记	#NAME?
转悠	#NAME?
撰写	#NAME?
庄稼	#NAME?
庄严	#NAME?
庄园	#NAME?
桩	#NAME?
装扮	#NAME?
壮	#NAME?
壮大	#NAME?
壮胆	#NAME?
壮丽	#NAME?
壮实	#NAME?
状元	#NAME?
撞击	#NAME?
幢	#NAME?
追悼会	#NAME?
追赶	#NAME?
追溯	#NAME?
追随	#NAME?
追尾	#NAME?
追问	#NAME?
追逐	#NAME?
追踪	#NAME?
坠	#NAME?
准许	#NAME?
准则	#NAME?
拙劣	#NAME?
捉迷藏	#NAME?
灼热	#NAME?
卓越	#NAME?
酌情	#NAME?
着力	#NAME?
着落	#NAME?
着实	#NAME?
着手	#NAME?
着想	#NAME?
着眼	#NAME?
着眼于	#NAME?
着重	#NAME?
姿势	#NAME?
姿态	#NAME?
兹	#NAME?
资本主义	#NAME?
资历	#NAME?
资深	#NAME?
资讯	#NAME?
滋润	#NAME?
滋味	#NAME?
子弟	#NAME?
子孙	#NAME?
自卑	#NAME?
自称	#NAME?
自发	#NAME?
自费	#NAME?
自负	#NAME?
自理	#NAME?
自力更生	#NAME?
自立	#NAME?
自强不息	#NAME?
自然而然	#NAME?
自然界	#NAME?
自如	#NAME?
自始至终	#NAME?
自私	#NAME?
自私自利	#NAME?
自卫	#NAME?
自相矛盾	#NAME?
自信心	#NAME?
自行	#NAME?
自以为是	#NAME?
自由自在	#NAME?
自责	#NAME?
自助	#NAME?
自尊	#NAME?
自尊心	#NAME?
字迹	#NAME?
字幕	#NAME?
字体	#NAME?
字眼	#NAME?
宗	#NAME?
宗旨	#NAME?
综上所述	#NAME?
总的来说	#NAME?
总额	#NAME?
总而言之	#NAME?
总计	#NAME?
纵观	#NAME?
纵横交错	#NAME?
纵然	#NAME?
纵容	#NAME?
纵深	#NAME?
粽子	#NAME?
走过场	#NAME?
走后门	#NAME?
走近	#NAME?
走廊	#NAME?
走投无路	#NAME?
走弯路	#NAME?
奏效	#NAME?
揍	#NAME?
租赁	#NAME?
足迹	#NAME?
足智多谋	#NAME?
阻挡	#NAME?
阻拦	#NAME?
阻力	#NAME?
阻挠	#NAME?
组建	#NAME?
组装	#NAME?
祖传	#NAME?
祖籍	#NAME?
祖先	#NAME?
祖宗	#NAME?
钻空子	#NAME?
钻研	#NAME?
钻石	#NAME?
嘴唇	#NAME?
罪犯	#NAME?
罪魁祸首	#NAME?
尊贵	#NAME?
尊严	#NAME?
遵循	#NAME?
遵照	#NAME?
琢磨	#NAME?
左顾右盼	#NAME?
佐料	#NAME?
作弊	#NAME?
作对	#NAME?
作风	#NAME?
作客	#NAME?
作物	#NAME?
坐落	#NAME?
座谈	#NAME?
座右铭	#NAME?
做生意	#NAME?
做证	#NAME?